Avakian	Armenian
Baghdassarian	Armenian
Barsamian	Armenian
Bedrosian	Armenian
Darbinian	Armenian
Davidyan	Armenian
Gevorgian	Armenian
Hagopian	Armenian
Hovanesian	Armenian
Kasabian	Armenian
Kevorkian	Armenian
Khachaturian	Armenian
Magorian	Armenian
Matevosian	Armenian
Mooshian	Armenian
Moushian	Armenian
Nazaretian	Armenian
Nazarian	Armenian
Panossian	Armenian
Sarkisian	Armenian
Torosian	Armenian
Vartanian	Armenian
Abaroa	Basque
Abasolo	Basque
Aiza	Basque
Aldana	Basque
Aritza	Basque
Arreola	Basque
Arriola	Basque
Azarola	Basque
Bengochea	Basque
Etxebarria	Basque
Garrastazu	Basque
Gebara	Basque
Ibarra	Basque
Iturburua	Basque
Jaso	Basque
Jasso	Basque
Loyola	Basque
Ochoa	Basque
Solo	Basque
Viteri	Basque
Ybarra	Basque
Zabala	Basque
Zuñiga	Basque
Abadjiev	Bulgarian
Aleksandrov	Bulgarian
Alekseev	Bulgarian
Andonov	Bulgarian
Andreev	Bulgarian
Angelov	Bulgarian
Antonov	Bulgarian
Antov	Bulgarian
Apostolov	Bulgarian
Asenov	Bulgarian
Atanasov	Bulgarian
Bakalov	Bulgarian
Bogdanov	Bulgarian
Borislavov	Bulgarian
Borisov	Bulgarian
Boyadjiev	Bulgarian
Boyanov	Bulgarian
Bozhidarov	Bulgarian
Buchvarov	Bulgarian
Chavdarov	Bulgarian
Chilikov	Bulgarian
Cvetkov	Bulgarian
Damyanov	Bulgarian
Danailov	Bulgarian
Danchev	Bulgarian
Danielov	Bulgarian
Daskalov	Bulgarian
Dimitrov	Bulgarian
Dimov	Bulgarian
Dobrev	Bulgarian
Draganov	Bulgarian
Dragomirov	Bulgarian
Dragov	Bulgarian
Filipov	Bulgarian
Furnadjiev	Bulgarian
Genadiev	Bulgarian
Genkov	Bulgarian
Genov	Bulgarian
Georgiev	Bulgarian
Goranov	Bulgarian
Grigorov	Bulgarian
Hadjiev	Bulgarian
Haralampiev	Bulgarian
Hristov	Bulgarian
Ignatiev	Bulgarian
Ignatov	Bulgarian
Iliev	Bulgarian
Isaev	Bulgarian
Ivankov	Bulgarian
Ivanov	Bulgarian
Ivov	Bulgarian
Kaloyanchev	Bulgarian
Kaloyanov	Bulgarian
Katranjiev	Bulgarian
Konstantinov	Bulgarian
Kovachev	Bulgarian
Krastev	Bulgarian
Lazarov	Bulgarian
Maksimov	Bulgarian
Marinov	Bulgarian
Markov	Bulgarian
Martinov	Bulgarian
Mateev	Bulgarian
Mihaylov	Bulgarian
Mihov	Bulgarian
Mikhailov	Bulgarian
Minkov	Bulgarian
Naoumov	Bulgarian
Naumov	Bulgarian
Nikolaev	Bulgarian
Nikolov	Bulgarian
Ognianov	Bulgarian
Ognyanov	Bulgarian
Pavlov	Bulgarian
Petrov	Bulgarian
Popov	Bulgarian
Radev	Bulgarian
Radkov	Bulgarian
Simeonov	Bulgarian
Slavkov	Bulgarian
Sokolov	Bulgarian
Stanev	Bulgarian
Stefanov	Bulgarian
Stoyanov	Bulgarian
Todorov	Bulgarian
Tomov	Bulgarian
Trifonov	Bulgarian
Tsvetanov	Bulgarian
Valentinov	Bulgarian
Valeriev	Bulgarian
Vanchev	Bulgarian
Vanev	Bulgarian
Vankov	Bulgarian
Vantchev	Bulgarian
Vasilev	Bulgarian
Velichkov	Bulgarian
Velitchkov	Bulgarian
Viktorov	Bulgarian
Vodenicharov	Bulgarian
Yanev	Bulgarian
Yankov	Bulgarian
Yordanov	Bulgarian
Zahariev	Bulgarian
Zdravkov	Bulgarian
Zhivkov	Bulgarian
Zlatkov	Bulgarian
Abelló	Catalan
Agramunt	Catalan
Albert	Catalan
Andreu	Catalan
Blanxart	Catalan
Bonaventura	Catalan
Cardona	Catalan
Castell	Catalan
Ferrer	Catalan
Grec	Catalan
Jordà	Catalan
Martí	Catalan
Mata	Catalan
Mateu	Catalan
Moles	Catalan
Noguerra	Catalan
Oliver	Catalan
Petit	Catalan
Picasso	Catalan
Porra	Catalan
Porras	Catalan
Puig	Catalan
Quintana	Catalan
Roig	Catalan
Rosa	Catalan
Sala	Catalan
Soler	Catalan
Tomàs	Catalan
Tosell	Catalan
Toset	Catalan
Ventura	Catalan
Vilaró	Catalan
Vivas	Catalan
Vives	Catalan
Chan	Chinese
Chen	Chinese
Cheung	Chinese
Huang	Chinese
Jiang	Chinese
Kuang	Chinese
Kwan	Chinese
Kwok	Chinese
Liao	Chinese
Sung	Chinese
Tang	Chinese
Wong	Chinese
Zhang	Chinese
Zhao	Chinese
Zheng	Chinese
Zhou	Chinese
Adamic	Croatian
Antic	Croatian
Ateljevic	Croatian
Babic	Croatian
Bogdanic	Croatian
Bogdanovic	Croatian
Brankovic	Croatian
Broz	Croatian
Crncevic	Croatian
Davidovic	Croatian
Dragic	Croatian
Dragovic	Croatian
Filipovic	Croatian
Franic	Croatian
Franjic	Croatian
Gavrilovic	Croatian
Horvat	Croatian
Horvatincic	Croatian
Ilic	Croatian
Ivanovic	Croatian
Jankovic	Croatian
Jovanovic	Croatian
Juric	Croatian
Juriša	Croatian
Kasun	Croatian
Knezevic	Croatian
Košar	Croatian
Kovac	Croatian
Loncar	Croatian
Lukic	Croatian
Markovic	Croatian
Marusic	Croatian
Matic	Croatian
Mihailovic	Croatian
Mihajlovic	Croatian
Milic	Croatian
Milojkevic	Croatian
Miloševic	Croatian
Milovanovic	Croatian
Mlakar	Croatian
Nikolic	Croatian
Pavletic	Croatian
Pavlovic	Croatian
Perko	Croatian
Petric	Croatian
Petrovic	Croatian
Radic	Croatian
Stankic	Croatian
Stefanovic	Croatian
Stjepanic	Croatian
Stojanovic	Croatian
Tomcic	Croatian
Vinkovic	Croatian
Vlahovic	Croatian
Vlasic	Croatian
Vlašic	Croatian
Vukoja	Croatian
Zivkovic	Croatian
Zoric	Croatian
Zupan	Croatian
Adamik	Czech
Andres	Czech
Banik	Czech
Baracnik	Czech
Bartoš	Czech
Beneš	Czech
Beran	Czech
Bernard	Czech
Biskup	Czech
Blaha	Czech
Blažek	Czech
Bobal	Czech
Bosko	Czech
Brož	Czech
Buranek	Czech
Bureš	Czech
Cech	Czech
Cermak	Czech
Cernik	Czech
Cerny	Czech
Cervenka	Czech
Chalupa	Czech
Chalupnik	Czech
Chmela	Czech
Chvátal	Czech
Ciernik	Czech
Cipris	Czech
Cižek	Czech
Ctvrtlanik	Czech
Ctvrtnik	Czech
David	Czech
Doležal	Czech
Doubek	Czech
Dušek	Czech
Dvorak	Czech
Fiala	Czech
Filipek	Czech
Hajek	Czech
Havel	Czech
Havelka	Czech
Holub	Czech
Horacek	Czech
Horak	Czech
Hornick	Czech
Hornik	Czech
Hrabe	Czech
Hruby	Czech
Hruška	Czech
Hustovi	Czech
Jahoda	Czech
Janda	Czech
Jankovic	Czech
Jedlicka	Czech
Jelen	Czech
Jelinek	Czech
Ježek	Czech
Kadlec	Czech
Kašpar	Czech
Kladivo	Czech
Klima	Czech
Klímek	Czech
Klimy	Czech
Kohout	Czech
Kolar	Czech
Kopecky	Czech
Kostelecky	Czech
Kovac	Czech
Kovác	Czech
Kovár	Czech
Krall	Czech
Kramr	Czech
Kratochvil	Czech
Krejci	Czech
Križ	Czech
Kucera	Czech
Kudrna	Czech
Kysely	Czech
Lanik	Czech
Láska	Czech
Lukska	Czech
Macek	Czech
Maly	Czech
Marek	Czech
Martinek	Czech
Maruska	Czech
Mašek	Czech
Maselnika	Czech
Matejka	Czech
Matoušek	Czech
Medved	Czech
Mlynarik	Czech
Moravec	Czech
Musil	Czech
Myska	Czech
Navrátil	Czech
Nedbalek	Czech
Nedved	Czech
Nemec	Czech
Nosek	Czech
Novak	Czech
Novosad	Czech
Novotny	Czech
Pechacek	Czech
Pešek	Czech
Podsednik	Czech
Pokorny	Czech
Polak	Czech
Pololanik	Czech
Pospíšil	Czech
Pražak	Czech
Prochazka	Czech
Pulkrábek	Czech
Pulnik	Czech
Reha	Czech
Reznicek	Czech
Rezník	Czech
Rybar	Czech
Sasha	Czech
Schovajsa	Czech
Sedlak	Czech
Šimek	Czech
Simon	Czech
Skala	Czech
Skalicky	Czech
Slavik	Czech
Slezak	Czech
Slovak	Czech
Smolák	Czech
Sokol	Czech
Sokoll	Czech
Stárek	Czech
Starosta	Czech
Štepanek	Czech
Strnad	Czech
Suchý	Czech
Svoboda	Czech
Sykora	Czech
Tesar	Czech
Tesarik	Czech
Vacek	Czech
Vacik	Czech
Valenta	Czech
Vancura	Czech
Vanek	Czech
Vašek	Czech
Vavra	Czech
Vesela	Czech
Vesely	Czech
Vlasák	Czech
Vrubel	Czech
Wentrcek	Czech
Yedlicka	Czech
Zahradnik	Czech
Zelenka	Czech
Zeman	Czech
Zíma	Czech
Žitník	Czech
Zupan	Czech
Abel	Danish
Abrahamsen	Danish
Abrahamssen	Danish
Abramsen	Danish
Abramssen	Danish
Adamsen	Danish
Adamssen	Danish
Akselsen	Danish
Albertsen	Danish
Alexandersen	Danish
Andersen	Danish
Andreasen	Danish
Anthonsen	Danish
Antonsen	Danish
Arthursen	Danish
Arthurssen	Danish
Axelsen	Danish
Bager	Danish
Bendtsen	Danish
Bentsen	Danish
Bjarnesen	Danish
Bodilsen	Danish
Carlsen	Danish
Carstensen	Danish
Christensen	Danish
Christiansen	Danish
Christoffersen	Danish
Clausen	Danish
Clemensen	Danish
Dahl	Danish
Danielsen	Danish
Davidsen	Danish
Doctor	Danish
Elmersen	Danish
Elmerssen	Danish
Eriksen	Danish
Falk	Danish
Fisker	Danish
Frederiksen	Danish
Giese	Danish
Guldbrandsen	Danish
Gunnarsen	Danish
Hall	Danish
Henningsen	Danish
Henriksen	Danish
Herbertsen	Danish
Herbertssen	Danish
Hermansen	Danish
Hermanssen	Danish
Hjort	Danish
Holgersen	Danish
Holst	Danish
Holt	Danish
Ibsen	Danish
Jacobsen	Danish
Jakobsen	Danish
Jensen	Danish
Jespersen	Danish
Johansen	Danish
Jokumsen	Danish
Jonasen	Danish
Jørgensen	Danish
Karlsen	Danish
Karstensen	Danish
Kaspersen	Danish
Kjeldsen	Danish
Klassen	Danish
Klausen	Danish
Knudsen	Danish
Kristensen	Danish
Kristiansen	Danish
Kristoffersen	Danish
Lang	Danish
Lange	Danish
Larsen	Danish
Lauritsen	Danish
Leonardsen	Danish
Leonardssen	Danish
Ludvigsen	Danish
Lund	Danish
Lykke	Danish
Madsen	Danish
Mathiasen	Danish
Matthiasen	Danish
Mikkelsen	Danish
Mortensen	Danish
Nielsen	Danish
Nikolajsen	Danish
Nordskov	Danish
Normansen	Danish
Normanssen	Danish
Norup	Danish
Nørup	Danish
Olesen	Danish
Oliversen	Danish
Oliverssen	Danish
Olsen	Danish
Øster	Danish
Østergaard	Danish
Østergård	Danish
Ottosen	Danish
Pallesen	Danish
Pedersen	Danish
Petersen	Danish
Poulsen	Danish
Prebensen	Danish
Randrup	Danish
Rask	Danish
Raske	Danish
Rasmussen	Danish
Reenberg	Danish
Riber	Danish
Robertsen	Danish
Salomon	Danish
Simonsen	Danish
Skovgaard	Danish
Solberg	Danish
Sørensen	Danish
Steensen	Danish
Stefansen	Danish
Steffensen	Danish
Stenberg	Danish
Stenger	Danish
Strand	Danish
Svendsen	Danish
Thorn	Danish
Thorsen	Danish
Troelsen	Danish
Vernersen	Danish
Victorsen	Danish
Vinter	Danish
Waltersen	Danish
Walterssen	Danish
Aafjes	Dutch
Aaij	Dutch
Aakster	Dutch
Aaldenberg	Dutch
Aalders	Dutch
Aalfs	Dutch
Aalmers	Dutch
Aaltink	Dutch
Aarden	Dutch
Aarens	Dutch
Aarle	Dutch
Aarse	Dutch
Aarts	Dutch
Aartsen	Dutch
Aartsma	Dutch
Abbes	Dutch
Abbing	Dutch
Abbingh	Dutch
Abbink	Dutch
Abel	Dutch
Abelen	Dutch
Abels	Dutch
Aben	Dutch
Abraham	Dutch
Abrahams	Dutch
Abrahamsen	Dutch
Abram	Dutch
Abrams	Dutch
Abramsen	Dutch
Abspoel	Dutch
Achilles	Dutch
Achterberg	Dutch
Achterkamp	Dutch
Achterop	Dutch
Adams	Dutch
Addens	Dutch
Addicks	Dutch
Addiks	Dutch
Adema	Dutch
Admiraal	Dutch
Adolfs	Dutch
Adriaans	Dutch
Adriaansen	Dutch
Adrichem	Dutch
Aerssens	Dutch
Agema	Dutch
Agterop	Dutch
Agthoven	Dutch
Ahlers	Dutch
Aikema	Dutch
Akker	Dutch
Akkerman	Dutch
Akkermans	Dutch
Akkersdijk	Dutch
Alberda	Dutch
Alberdink	Dutch
Alberink	Dutch
Albers	Dutch
Albersnagel	Dutch
Alberts	Dutch
Albring	Dutch
Albronda	Dutch
Aldenberg	Dutch
Aldenkamp	Dutch
Alderliesten	Dutch
Alders	Dutch
Aldershof	Dutch
Alferdinck	Dutch
Alferink	Dutch
Alfons	Dutch
Aling	Dutch
Alink	Dutch
Alles	Dutch
Alma	Dutch
Altena	Dutch
Althuis	Dutch
Alting	Dutch
Altink	Dutch
Amsing	Dutch
Ananias	Dutch
Andela	Dutch
Andries	Dutch
Andriessen	Dutch
Andringa	Dutch
Angenent	Dutch
Anholts	Dutch
Anker	Dutch
Anneijes	Dutch
Annevelink	Dutch
Antema	Dutch
Antonis	Dutch
Antonise	Dutch
Antonisen	Dutch
Antuma	Dutch
Aperlo	Dutch
Appeldoorn	Dutch
Appelhof	Dutch
Appelo	Dutch
Apperlo	Dutch
Arbeid	Dutch
Arbeider	Dutch
Arbeit	Dutch
Arendonk	Dutch
Arends	Dutch
Arendse	Dutch
Arendsen	Dutch
Arents	Dutch
Arentz	Dutch
Ariesen	Dutch
Arissen	Dutch
Arkes	Dutch
Arntz	Dutch
Arntzen	Dutch
Arntzenius	Dutch
Artz	Dutch
Asjes	Dutch
Askes	Dutch
Asselman	Dutch
Assenberg	Dutch
Assendorp	Dutch
Assies	Dutch
Assink	Dutch
Atses	Dutch
Aukes	Dutch
Averesch	Dutch
Aveskamp	Dutch
Baaiman	Dutch
Baak	Dutch
Baanders	Dutch
Baardwijk	Dutch
Baars	Dutch
Baart	Dutch
Baas	Dutch
Baasch	Dutch
Bachman	Dutch
Bakhuizen	Dutch
Bakker	Dutch
Barends	Dutch
Benscoter	Dutch
Beringer	Dutch
Beulen	Dutch
Beulens	Dutch
Beullens	Dutch
Beumers	Dutch
Bezuidenhout	Dutch
Boer	Dutch
Boerefijn	Dutch
Bootsma	Dutch
Borst	Dutch
Bosch	Dutch
Bouwmeester	Dutch
Braband	Dutch
Brams	Dutch
Brinkerhoff	Dutch
Bulle	Dutch
Bullens	Dutch
Carl	Dutch
Ceelen	Dutch
Claasen	Dutch
Cloet	Dutch
Cloeten	Dutch
Coeman	Dutch
Coemans	Dutch
Coenen	Dutch
Colijn	Dutch
Coolen	Dutch
Couman	Dutch
Coumans	Dutch
Crusan	Dutch
Cuijper	Dutch
Cuijpers	Dutch
Cuyper	Dutch
Cuypers	Dutch
Daalman	Dutch
Daalmans	Dutch
Daelman	Dutch
Daelmans	Dutch
Dahl	Dutch
Dahlman	Dutch
Dahlmans	Dutch
Daube	Dutch
De Cloet	Dutch
De Groot	Dutch
De Haven	Dutch
De Jonckheer	Dutch
De Jonker	Dutch
De Klerk	Dutch
De Kloet	Dutch
De Snaaijer	Dutch
De Snaijer	Dutch
De Veen	Dutch
De Ven	Dutch
De Vroom	Dutch
De Vroome	Dutch
De Wit	Dutch
De With	Dutch
De Witt	Dutch
De Witte	Dutch
Derichs	Dutch
Dierickx	Dutch
Dirchs	Dutch
Dircks	Dutch
Dirckse	Dutch
Dircksen	Dutch
Dircksens	Dutch
Dirckx	Dutch
Diriks	Dutch
Dirikx	Dutch
Dirix	Dutch
Dirks	Dutch
Dirkse	Dutch
Dirksen	Dutch
Dirkx	Dutch
Drees	Dutch
Dreese	Dutch
Dreesen	Dutch
Dreesens	Dutch
Dreessen	Dutch
Dreessens	Dutch
Dreyer	Dutch
Dries	Dutch
Driessen	Dutch
Dykstra	Dutch
Eerkens	Dutch
Eikenboom	Dutch
Elzinga	Dutch
Erckens	Dutch
Erkens	Dutch
Evers	Dutch
Flipse	Dutch
Flipsen	Dutch
Fortuin	Dutch
Fortuyn	Dutch
Franke	Dutch
Geelen	Dutch
Geelens	Dutch
Geels	Dutch
Gelen	Dutch
Gelens	Dutch
Haak	Dutch
Haanraads	Dutch
Haanraadts	Dutch
Haanraats	Dutch
Haanrath	Dutch
Haas	Dutch
Haenraats	Dutch
Haenraets	Dutch
Hanraets	Dutch
Haumann	Dutch
Heeren	Dutch
Heijman	Dutch
Heijmans	Dutch
Heiman	Dutch
Heimans	Dutch
Hendriks	Dutch
Hendrikx	Dutch
Hendrix	Dutch
Herbert	Dutch
Herberts	Dutch
Herbertsen	Dutch
Herbertssen	Dutch
Herrema	Dutch
Heyman	Dutch
Heymans	Dutch
Hoedemaeker	Dutch
Hoedemaekers	Dutch
Hoedemaker	Dutch
Hoedemakers	Dutch
Hofwegen	Dutch
Holst	Dutch
Holt	Dutch
Holtman	Dutch
Houben	Dutch
Houtkooper	Dutch
Houtman	Dutch
Jacobs	Dutch
Jacobse	Dutch
Jacobson	Dutch
Jans	Dutch
Jansen	Dutch
Jansens	Dutch
Jansing	Dutch
Jansingh	Dutch
Jansink	Dutch
Janssen	Dutch
Janssens	Dutch
Janz	Dutch
Janzen	Dutch
Joncker	Dutch
Jonckers	Dutch
Jonckersen	Dutch
Jonckheer	Dutch
Jonker	Dutch
Jonkers	Dutch
Joosten	Dutch
Kappel	Dutch
Karl	Dutch
Kikkert	Dutch
Klein	Dutch
Klerk	Dutch
Klerken	Dutch
Klerks	Dutch
Klerkse	Dutch
Klerkx	Dutch
Klerx	Dutch
Kloet	Dutch
Kloeten	Dutch
Kloeter	Dutch
Koeman	Dutch
Koemans	Dutch
Kolen	Dutch
Kolijn	Dutch
Kollen	Dutch
Koning	Dutch
Kool	Dutch
Koole	Dutch
Koolen	Dutch
Kools	Dutch
Kouman	Dutch
Koumans	Dutch
Krantz	Dutch
Kranz	Dutch
Krusen	Dutch
Kuijpers	Dutch
Kuiper	Dutch
Kuipers	Dutch
Langbroek	Dutch
Lauwens	Dutch
Lauwers	Dutch
Leeuwenhoek	Dutch
Lucas	Dutch
Lucassen	Dutch
Lyon	Dutch
Maas	Dutch
Maessen	Dutch
Marquering	Dutch
Marqueringh	Dutch
Marquerink	Dutch
Meeuwe	Dutch
Meeuwes	Dutch
Meeuwessen	Dutch
Meeuweszen	Dutch
Meeuwis	Dutch
Meeuwissen	Dutch
Meeuwsen	Dutch
Meisner	Dutch
Merckx	Dutch
Mertens	Dutch
Mohren	Dutch
Mooren	Dutch
Mulder	Dutch
Muyskens	Dutch
Nelissen	Dutch
Nifterick	Dutch
Nifterik	Dutch
Niftrik	Dutch
Offermans	Dutch
Ogterop	Dutch
Oomen	Dutch
Oorschot	Dutch
Otten	Dutch
Pander	Dutch
Panders	Dutch
Paulis	Dutch
Paulissen	Dutch
Peerenboom	Dutch
Peeters	Dutch
Pender	Dutch
Penders	Dutch
Pennders	Dutch
Penner	Dutch
Penners	Dutch
Peter	Dutch
Peusen	Dutch
Philips	Dutch
Prinsen	Dutch
Rademaker	Dutch
Rademakers	Dutch
Ramaaker	Dutch
Ramaker	Dutch
Ramakers	Dutch
Ramecker	Dutch
Rameckers	Dutch
Raske	Dutch
Reijnder	Dutch
Reijnders	Dutch
Reinder	Dutch
Reinders	Dutch
Reynder	Dutch
Reynders	Dutch
Richard	Dutch
Rietveld	Dutch
Rijnder	Dutch
Rijnders	Dutch
Robert	Dutch
Roggeveen	Dutch
Roijacker	Dutch
Roijackers	Dutch
Roijakker	Dutch
Roijakkers	Dutch
Romeijn	Dutch
Romeijnders	Dutch
Romeijnsen	Dutch
Romijn	Dutch
Romijnders	Dutch
Romijnsen	Dutch
Rompa	Dutch
Rooiakker	Dutch
Rooiakkers	Dutch
Rooijakker	Dutch
Rooijakkers	Dutch
Roosa	Dutch
Roosevelt	Dutch
Rutten	Dutch
Ryskamp	Dutch
Samson	Dutch
Schenck	Dutch
Schermer	Dutch
Schneiders	Dutch
Schneijder	Dutch
Schneijders	Dutch
Schoonenburg	Dutch
Schoonraad	Dutch
Schoorel	Dutch
Schoorl	Dutch
Schorel	Dutch
Schrijnemakers	Dutch
Schuyler	Dutch
Schwarzenberg	Dutch
Seeger	Dutch
Seegers	Dutch
Seelen	Dutch
Segers	Dutch
Segher	Dutch
Seghers	Dutch
Severijns	Dutch
Severins	Dutch
Sevriens	Dutch
Silje	Dutch
Simon	Dutch
Simonis	Dutch
Slootmaekers	Dutch
Smeets	Dutch
Smets	Dutch
Smit	Dutch
Smits	Dutch
Snaaijer	Dutch
Snaijer	Dutch
Sneiders	Dutch
Sneijder	Dutch
Sneijders	Dutch
Sneijer	Dutch
Sneijers	Dutch
Snell	Dutch
Snider	Dutch
Sniders	Dutch
Snijder	Dutch
Snijders	Dutch
Snyder	Dutch
Snyders	Dutch
Specht	Dutch
Spiker	Dutch
Ter Avest	Dutch
Teunissen	Dutch
Theunissen	Dutch
Tholberg	Dutch
Tillens	Dutch
Tunison	Dutch
Tunneson	Dutch
Van 't Hout	Dutch
Van Aalsburg	Dutch
Van Aalst	Dutch
Van Aarle	Dutch
Van Achteren	Dutch
Van Achthoven	Dutch
Van Adrichem	Dutch
Van Aggelen	Dutch
Van Agteren	Dutch
Van Agthoven	Dutch
Van Akkeren	Dutch
Van Aller	Dutch
Van Alphen	Dutch
Van Alst	Dutch
Van Altena	Dutch
Van Althuis	Dutch
Van Amelsvoort	Dutch
Van Amersvoort	Dutch
Van Amstel	Dutch
Van Andel	Dutch
Van Andringa	Dutch
Van Ankeren	Dutch
Van Antwerp	Dutch
Van Antwerpen	Dutch
Van Apeldoorn	Dutch
Van Arendonk	Dutch
Van As	Dutch
Van Asch	Dutch
Van Assen	Dutch
Van Baarle	Dutch
Van Bokhoven	Dutch
Van Breda	Dutch
Van Bueren	Dutch
Van Buggenum	Dutch
Van Buiren	Dutch
Van Buren	Dutch
Van Can	Dutch
Van Cann	Dutch
Van Canne	Dutch
Van Daal	Dutch
Van Daalen	Dutch
Van Dael	Dutch
Van Daele	Dutch
Van Dale	Dutch
Van Dalen	Dutch
Van De Laar	Dutch
Van De Vliert	Dutch
Van den Akker	Dutch
Van den Andel	Dutch
Van Denend	Dutch
Van der Aart	Dutch
Van der As	Dutch
Van der Beek	Dutch
Van der Berg	Dutch
Van der Hout	Dutch
Van der Laar	Dutch
Van der See	Dutch
Van der Stoep	Dutch
Van der Veen	Dutch
Van der Ven	Dutch
Van der Venn	Dutch
Van der Venne	Dutch
Van der Vennen	Dutch
Van der Zee	Dutch
Van Donk	Dutch
Van Haanraads	Dutch
Van Haanraats	Dutch
Van Haanrade	Dutch
Van Haanrath	Dutch
Van Haenraats	Dutch
Van Haenraets	Dutch
Van Hanraets	Dutch
Van Hassel	Dutch
Van Hautem	Dutch
Van Hautum	Dutch
Van Heel	Dutch
Van Herten	Dutch
Van Hofwegen	Dutch
Van Hout	Dutch
Van Houte	Dutch
Van Houtem	Dutch
Van Houten	Dutch
Van Houttum	Dutch
Van Houtum	Dutch
Van Kan	Dutch
Van Kann	Dutch
Van Kanne	Dutch
Van Laar	Dutch
Van Laren	Dutch
Van Leeuwenhoeck	Dutch
Van Leeuwenhoek	Dutch
Van Middelburg	Dutch
Van Middlesworth	Dutch
Van Nifterick	Dutch
Van Nifterik	Dutch
Van Niftrik	Dutch
Van Ogtrop	Dutch
Van Oirschot	Dutch
Van Oirschotten	Dutch
Van Oorschot	Dutch
Van Ophoven	Dutch
Van Peij	Dutch
Van Pey	Dutch
Van Rompa	Dutch
Van Rompaeij	Dutch
Van Rompaey	Dutch
Van Rompaij	Dutch
Van Rompay	Dutch
Van Rompaye	Dutch
Van Rompu	Dutch
Van Rompuy	Dutch
Van Rossem	Dutch
Van Rossum	Dutch
Van Rumpade	Dutch
Van Schoorel	Dutch
Van Schoorl	Dutch
Van Schorel	Dutch
Van Veen	Dutch
Van Veenen	Dutch
Van Wegberg	Dutch
Van Wieren	Dutch
Van Willigen	Dutch
Vandale	Dutch
Venner	Dutch
Verboom	Dutch
Vergoossen	Dutch
Verhoeven	Dutch
Ververs	Dutch
Victor	Dutch
Victors	Dutch
Victorsz	Dutch
Visscher	Dutch
Vogels	Dutch
Vossen	Dutch
Vroom	Dutch
Vroomen	Dutch
Wauters	Dutch
Westenberg	Dutch
Willems	Dutch
Willemse	Dutch
Willemsen	Dutch
Wilms	Dutch
Wolters	Dutch
Wouters	Dutch
Yonker	Dutch
Yonkers	Dutch
Zaal	Dutch
Zeeger	Dutch
Zeegers	Dutch
Zeelen	Dutch
Zegers	Dutch
Zegher	Dutch
Zeghers	Dutch
Zuiderduin	Dutch
Abbey	English
Abel	English
Abraham	English
Abrahams	English
Abrahamson	English
Abram	English
Abrams	English
Abramson	English
Achilles	English
Acker	English
Ackerman	English
Adam	English
Adams	English
Adamson	English
Adcock	English
Addison	English
Adkins	English
Aiken	English
Ainsworth	English
Aitken	English
Akerman	English
Akers	English
Albert	English
Alberts	English
Albinson	English
Alexander	English
Alfredson	English
Alfson	English
Allard	English
Allen	English
Allsopp	English
Alvey	English
Anderson	English
Andrews	English
Andrewson	English
Anson	English
Anthonyson	English
Appleby	English
Appleton	English
Archer	English
Arkwright	English
Armistead	English
Arnold	English
Arrington	English
Arterberry	English
Arterbury	English
Arthur	English
Arthurson	English
Ash	English
Ashley	English
Ashworth	English
Atkins	English
Atkinson	English
Attaway	English
Atteberry	English
Atterberry	English
Attwater	English
Augustine	English
Auteberry	English
Autenberry	English
Auttenberg	English
Avery	English
Ayers	English
Ayton	English
Babcock	English
Babcocke	English
Babcoke	English
Backus	English
Badcock	English
Badcocke	English
Badcoke	English
Bagley	English
Bailey	English
Baines	English
Baker	English
Baldwin	English
Bancroft	English
Banister	English
Banks	English
Barber	English
Bardsley	English
Barker	English
Barlow	English
Barnes	English
Barton	English
Bartram	English
Bass	English
Bates	English
Bateson	English
Battle	English
Batts	English
Baxter	English
Beake	English
Beasley	English
Beattie	English
Beck	English
Becket	English
Beckett	English
Beckham	English
Belcher	English
Bell	English
Bellamy	English
Benbow	English
Benjaminson	English
Bennet	English
Bennett	English
Benson	English
Benton	English
Bernard	English
Berry	English
Bird	English
Bishop	English
Black	English
Blackbourne	English
Blackburn	English
Blackman	English
Blackwood	English
Blake	English
Blakeslee	English
Bloodworth	English
Bloxam	English
Bloxham	English
Blue	English
Blythe	English
Boivin	English
Bolton	English
Bond	English
Bonham	English
Bonher	English
Bonner	English
Bonney	English
Boon	English
Boone	English
Booner	English
Boothman	English
Botwright	English
Bourke	English
Boyce	English
Braddock	English
Bradford	English
Bradley	English
Brams	English
Bramson	English
Brasher	English
Brassington	English
Bray	English
Breckenridge	English
Breckinridge	English
Brent	English
Brewer	English
Brewster	English
Brigham	English
Bristol	English
Bristow	English
Britton	English
Broadbent	English
Brock	English
Brooks	English
Brown	English
Brownlow	English
Bryant	English
Bryson	English
Buckley	English
Bullard	English
Bulle	English
Bullock	English
Bunker	English
Burke	English
Burnham	English
Burns	English
Burrell	English
Burton	English
Bush	English
Butcher	English
Butler	English
Butts	English
Byrd	English
Cannon	English
Cantrell	English
Carl	English
Carlisle	English
Carlyle	English
Carman	English
Carpenter	English
Carter	English
Cartwright	English
Carver	English
Caulfield	English
Causer	English
Causey	English
Chamberlain	English
Chance	English
Chancellor	English
Chandler	English
Chapman	English
Chase	English
Cheshire	English
Christians	English
Christianson	English
Christinsen	English
Christinson	English
Christisen	English
Christison	English
Christopher	English
Christophers	English
Christopherson	English
Church	English
Clark	English
Clarke	English
Clarkson	English
Clausson	English
Clawson	English
Clayton	English
Clemens	English
Clifford	English
Cline	English
Clinton	English
Close	English
Coburn	English
Cock	English
Cockburn	English
Cocks	English
Coel	English
Coke	English
Cokes	English
Cole	English
Coleman	English
Collingwood	English
Collins	English
Combs	English
Comstock	English
Constable	English
Cook	English
Cooke	English
Cookson	English
Coombs	English
Cooper	English
Corra	English
Cotterill	English
Cowden	English
Cox	English
Crawford	English
Crewe	English
Cristians	English
Cristiansen	English
Cristianson	English
Croft	English
Cropper	English
Cross	English
Crouch	English
Cummins	English
Curtis	English
Dalton	English
Danell	English
Daniel	English
Daniell	English
Daniels	English
Danielson	English
Dannel	English
Danniel	English
Danniell	English
Darby	English
Daugherty	English
David	English
Davidson	English
Davies	English
Davis	English
Davison	English
Dawson	English
Day	English
Deadman	English
Dean	English
Deering	English
Denman	English
Dennel	English
Dennell	English
Derrick	English
Derricks	English
Derrickson	English
Dexter	English
Dick	English
Dickens	English
Dickenson	English
Dickinson	English
Dickman	English
Dickson	English
Disney	English
Dixon	English
Donalds	English
Donaldson	English
Downer	English
Draper	English
Duke	English
Dukeson	English
Durand	English
Durant	English
Dwerryhouse	English
Dyer	English
Eads	English
Earl	English
Earls	English
Earlson	English
Easom	English
Eason	English
Eaton	English
Eccleston	English
Ecclestone	English
Edison	English
Edwards	English
Edwardson	English
Elder	English
Eldridge	English
Elliot	English
Ellison	English
Ellisson	English
Elliston	English
Ellsworth	English
Elmerson	English
Ely	English
Emerson	English
Endicott	English
English	English
Ericson	English
Espenson	English
Ethans	English
Ethanson	English
Eustis	English
Evanson	English
Evered	English
Extra:	English
Fabian	English
Fairbairn	English
Fairburn	English
Fairchild	English
Fairclough	English
Farnham	English
Faulkner	English
Fay	English
Fear	English
Fenn	English
Firmin	English
Fisher	English
Fishman	English
Fitzroy	English
Fleming	English
Fletcher	English
Ford	English
Forester	English
Forney	English
Foss	English
Foster	English
Fox	English
Frank	English
Franklin	English
Freeman	English
Frost	English
Fry	English
Frye	English
Fuller	English
Gabriels	English
Gabrielson	English
Gardenar	English
Gardener	English
Gardiner	English
Gardner	English
Gardyner	English
Garner	English
Garrard	English
Garrod	English
Georgeson	English
Gibb	English
Gibbs	English
Gibson	English
Gilbert	English
Giles	English
Gilliam	English
Glover	English
Godfrey	English
Goffe	English
Goode	English
Gorbold	English
Gore	English
Granger	English
Grant	English
Gray	English
Green	English
Greene	English
Gregory	English
Grey	English
Griffin	English
Groves	English
Gully	English
Hackett	English
Hadaway	English
Haden	English
Haggard	English
Haight	English
Hale	English
Hall	English
Hallman	English
Hambledon	English
Hambleton	English
Hameldon	English
Hamilton	English
Hamm	English
Hampson	English
Hampton	English
Hancock	English
Hanley	English
Hanson	English
Harden	English
Hardwick	English
Hardy	English
Harford	English
Hargrave	English
Harley	English
Harlow	English
Harman	English
Harmon	English
Haroldson	English
Harper	English
Harrell	English
Harrelson	English
Harris	English
Harrison	English
Hart	English
Hartell	English
Harvey	English
Hathaway	English
Hatheway	English
Hathoway	English
Haward	English
Hawk	English
Hawking	English
Hawkins	English
Hayden	English
Hayes	English
Hayward	English
Haywood	English
Head	English
Heath	English
Henderson	English
Hendry	English
Henryson	English
Henson	English
Hepburn	English
Herbert	English
Herberts	English
Herbertson	English
Hermanson	English
Hewitt	English
Hext	English
Hibbert	English
Hicks	English
Hightower	English
Hill	English
Hillam	English
Hilton	English
Hobbes	English
Hobbs	English
Hobson	English
Hodges	English
Hodson	English
Hogarth	English
Hollands	English
Hollins	English
Holme	English
Holmes	English
Holmwood	English
Holt	English
Honeycutt	English
Honeysett	English
Hooker	English
Hooper	English
Hope	English
Hopkins	English
Hopper	English
Hopson	English
Horn	English
Horne	English
Horsfall	English
Horton	English
House	English
Howard	English
Howe	English
Howland	English
Howse	English
Huddleson	English
Huddleston	English
Hudnall	English
Hudson	English
Huff	English
Hughes	English
Hull	English
Hume	English
Hunnisett	English
Hunt	English
Hunter	English
Hurst	English
Hutson	English
Huxley	English
Huxtable	English
Hyland	English
I'Anson	English
Ibbot	English
Ibbott	English
Ikin	English
Ingham	English
Ingram	English
Irving	English
Isaacson	English
Ivers	English
Jack	English
Jackson	English
Jacobs	English
Jacobson	English
Jakeman	English
James	English
Jamison	English
Jans	English
Janson	English
Jardine	English
Jarvis	English
Jeanes	English
Jeffers	English
Jefferson	English
Jeffery	English
Jeffries	English
Jenkins	English
Jephson	English
Jepson	English
Jernigan	English
Jerome	English
Jinks	English
Johns	English
Johnson	English
Joiner	English
Jones	English
Jordan	English
Josephs	English
Josephson	English
Joyner	English
Kay	English
Keegan	English
Keen	English
Kellogg	English
Kelsey	English
Kemp	English
Kendall	English
Kendrick	English
Kersey	English
Kevins	English
Kevinson	English
Key	English
Keys	English
Kidd	English
Killam	English
Kimball	English
King	English
Kipling	English
Kirby	English
Kitchen	English
Kitchens	English
Knaggs	English
Knight	English
Lane	English
Langley	English
Law	English
Lawrence	English
Lawson	English
Leach	English
Leavitt	English
Ledford	English
Lee	English
Leon	English
Leonardson	English
Levitt	English
Lewis	English
Linwood	English
Little	English
Lockwood	English
Loman	English
Long	English
Longstaff	English
Low	English
Lowe	English
Lowry	English
Lucas	English
Lukeson	English
Lum	English
Lund	English
Lynn	English
Lyon	English
Maddison	English
Madison	English
Mallory	English
Malone	English
Mann	English
Marchand	English
Mark	English
Marley	English
Marlow	English
Marsden	English
Marshall	English
Marston	English
Martel	English
Martell	English
Martin	English
Martins	English
Martinson	English
Mason	English
Masters	English
Masterson	English
Mathers	English
Mathews	English
Mathewson	English
Matthews	English
Matthewson	English
May	English
Mayer	English
Mayes	English
Meadows	English
Mercer	English
Merchant	English
Merrick	English
Merricks	English
Merrickson	English
Merritt	English
Michael	English
Michaels	English
Michaelson	English
Midgley	English
Milburn	English
Miles	English
Milford	English
Miller	English
Millhouse	English
Mills	English
Milton	English
Mitchell	English
Monday	English
Mondy	English
Montgomery	English
Moore	English
Moores	English
Moors	English
Morce	English
Morison	English
Morris	English
Morrish	English
Morrison	English
Morriss	English
Morse	English
Moses	English
Mottershead	English
Mounce	English
Murgatroyd	English
Murray	English
Muttoone	English
Myers	English
Myles	English
Nathans	English
Nathanson	English
Nelson	English
Ness	English
Neville	English
Newell	English
Newman	English
Newport	English
Newton	English
Nichols	English
Nicholson	English
Nicolson	English
Nielson	English
Nigel	English
Nixon	English
Normanson	English
Norris	English
North	English
Northrop	English
Norwood	English
Nye	English
Oakley	English
Odell	English
Ogden	English
Olhouser	English
Oliver	English
Oliverson	English
Orman	English
Osborne	English
Osbourne	English
Ott	English
Outlaw	English
Outterridge	English
Overton	English
Owston	English
Padmore	English
Page	English
Paget	English
Palmer	English
Parent	English
Parish	English
Parker	English
Parsons	English
Paternoster	English
Paterson	English
Patrick	English
Patrickson	English
Patterson	English
Patton	English
Paulson	English
Payne	English
Peacock	English
Peak	English
Pearson	English
Peck	English
Pelley	English
Pemberton	English
Penny	English
Perkins	English
Perry	English
Peter	English
Peters	English
Peterson	English
Petit	English
Pettigrew	English
Philips	English
Phillips	English
Pickering	English
Pickle	English
Pierson	English
Pitts	English
Plank	English
Plaskett	English
Platt	English
Pocock	English
Polley	English
Pond	English
Poole	English
Pope	English
Porcher	English
Porter	English
Potter	English
Pound	English
Power	English
Powers	English
Prescott	English
Pressley	English
Preston	English
Proudfoot	English
Pryor	English
Purcell	English
Putnam	English
Queen	English
Queshire	English
Quick	English
Quickley	English
Quigg	English
Quigley	English
Quincey	English
Quincy	English
Raines	English
Rains	English
Rake	English
Rakes	English
Ramsey	English
Randall	English
Ray	English
Rayne	English
Raynerson	English
Read	English
Readdie	English
Ready	English
Reed	English
Reeve	English
Reid	English
Reier	English
Rennell	English
Rennold	English
Rennoll	English
Revie	English
Rey	English
Reynell	English
Reynolds	English
Rice	English
Richard	English
Richards	English
Richardson	English
Rickard	English
Rider	English
Ridley	English
Rier	English
Rigby	English
Riley	English
Rimmer	English
Roach	English
Robbins	English
Robert	English
Roberts	English
Robertson	English
Robinson	English
Roderick	English
Rogers	English
Rogerson	English
Rollins	English
Rome	English
Romilly	English
Roscoe	English
Rose	English
Ross	English
Rounds	English
Rowbottom	English
Rowe	English
Rowland	English
Rowntree	English
Roy	English
Royce	English
Royceston	English
Roydon	English
Royle	English
Royston	English
Ruggles	English
Rupertson	English
Rush	English
Ruskin	English
Russell	English
Ryder	English
Rye	English
Ryeley	English
Ryely	English
Ryer	English
Ryers	English
Ryley	English
Sackville	English
Sadler	English
Salomon	English
Salvage	English
Sampson	English
Samson	English
Samuel	English
Samuels	English
Samuelson	English
Sanders	English
Sanderson	English
Sandford	English
Sands	English
Sangster	English
Sappington	English
Sargent	English
Saunders	English
Sauvage	English
Savage	English
Savege	English
Savidge	English
Sawyer	English
Saylor	English
School	English
Scott	English
Scriven	English
Scrivener	English
Scrivenor	English
Scrivens	English
Seabrooke	English
Seaver	English
Sempers	English
Senior	English
Sergeant	English
Sessions	English
Seward	English
Sexton	English
Seymour	English
Shakesheave	English
Sharman	English
Sharrow	English
Shelby	English
Shepard	English
Sherburne	English
Sherman	English
Shine	English
Simmons	English
Simms	English
Simon	English
Simons	English
Simonson	English
Simpkin	English
Simpson	English
Sims	English
Skinner	English
Slater	English
Smalls	English
Smedley	English
Smith	English
Smythe	English
Snelling	English
Snider	English
Sniders	English
Snyder	English
Snyders	English
Southers	English
Southgate	English
Sowards	English
Spalding	English
Sparks	English
Spear	English
Spearing	English
Spears	English
Speight	English
Spence	English
Spencer	English
Spooner	English
Spurling	English
St John	English
Stack	English
Stacks	English
Stafford	English
Stainthorpe	English
Stamp	English
Stanton	English
Stark	English
Starr	English
Statham	English
Steed	English
Steele	English
Steffen	English
Stenet	English
Stephens	English
Stephenson	English
Stern	English
Stevens	English
Stevenson	English
Stidolph	English
Stoddard	English
Strange	English
Street	English
Strickland	English
Stringer	English
Stroud	English
Strudwick	English
Studwick	English
Styles	English
Sudworth	English
Suggitt	English
Summerfield	English
Summers	English
Sumner	English
Sutton	English
Sweet	English
Swindlehurst	English
Symons	English
Tailor	English
Tanner	English
Tash	English
Tasker	English
Tate	English
Tatham	English
Taylor	English
Teel	English
Tennison	English
Tennyson	English
Thacker	English
Thatcher	English
Thomas	English
Thompsett	English
Thompson	English
Thomson	English
Thorn	English
Thorne	English
Thorpe	English
Thrussell	English
Thwaite	English
Tifft (1)	English
Timberlake	English
Timothyson	English
Tinker	English
Tipton	English
Tittensor	English
Tobias	English
Toft	English
Tolbert	English
Tollemache	English
Toller	English
Towner	English
Townsend	English
Tracey	English
Tracy	English
Traiylor	English
Trask	English
Traver	English
Travers	English
Traves	English
Travis	English
Traviss	English
Traylor	English
Treloar	English
Trengove	English
Trent	English
Trevis	English
Triggs	English
Tucker	English
Tuff	English
Tuft	English
Tupper	English
Turnbull	English
Turner	English
Tyler	English
Tyson	English
Underhill	English
Underwood	English
Upton	English
Usage:	English
Van Middlesworth	English
Vance	English
Vann	English
Varley	English
Varnham	English
Vaughan	English
Vaughn	English
Verity	English
Vernon	English
Victor	English
Victors	English
Victorson	English
Vincent	English
Vipond	English
Virgo	English
Wakefield	English
Walker	English
Wallace	English
Waller	English
Wallis	English
Walmsley	English
Walsh	English
Walter	English
Walterson	English
Walton	English
Ward	English
Wardrobe	English
Ware	English
Warren	English
Wash	English
Washington	English
Waterman	English
Waters	English
Watkins	English
Watson	English
Way	English
Weaver	English
Webster	English
Weekes	English
Wembley	English
Wescott	English
Westbrook	English
Wheeler	English
Wheelock	English
Whinery	English
Whitaker	English
White	English
Whitney	English
Whittemore	English
Whittle	English
Wickham	English
Wilcox	English
Wilkerson	English
Wilkins	English
Wilkinson	English
William	English
Williams	English
Williamson	English
Willis	English
Willoughby	English
Wilson	English
Winchester	English
Winfield	English
Winship	English
Winston	English
Winter	English
Winterbottom	English
Winthrop	English
Witherspoon	English
Wolf	English
Wolfe	English
Womack	English
Wood	English
Woodcock	English
Woodham	English
Woodhams	English
Woods	English
Woodward	English
Wootton	English
Wortham	English
Wragge	English
Wray	English
Wright	English
Wyatt	English
Wyght	English
Wyman	English
Wyndham	English
Yap	English
Yates	English
Yong	English
York	English
Young	English
Younge	English
Yoxall	English
Aalto	Finnish
Harmaajärvi	Finnish
Heikki	Finnish
Jarvi	Finnish
Järvinen	Finnish
Jokela	Finnish
Jokinen	Finnish
Karppinen	Finnish
Kulmala	Finnish
Laakkonen	Finnish
Laaksonen	Finnish
Lahti	Finnish
Laukkanen	Finnish
Lehtonen	Finnish
Linna	Finnish
Mustanen	Finnish
Nikula	Finnish
Nurmi	Finnish
Nylund	Finnish
Pajari	Finnish
Partanen	Finnish
Pekkanen	Finnish
Pentti	Finnish
Peura	Finnish
Ranta	Finnish
Rautio	Finnish
Ruoho	Finnish
Ruotsalainen	Finnish
Saari	Finnish
Seppä	Finnish
Seppänen	Finnish
Tähtinen	Finnish
Takala	Finnish
Toivonen	Finnish
Vanhanen	Finnish
Venäläinen	Finnish
Virtanen	Finnish
Wuopio	Finnish
Abel	French
Abney	French
Abraham	French
Adam	French
Albert	French
Allard	French
Archambault	French
Armistead	French
Arthur	French
Augustin	French
Babineaux	French
Baudin	French
Beauchene	French
Beaulieu	French
Beaumont	French
Bélanger	French
Bellamy	French
Bellerose	French
Belrose	French
Béringer	French
Bernard	French
Bertrand	French
Bisset	French
Bissette	French
Blaise	French
Blanc	French
Blanchet	French
Blanchett	French
Bonfils	French
Bonheur	French
Bonhomme	French
Bonnaire	French
Bonnay	French
Bonner	French
Bonnet	French
Borde	French
Bordelon	French
Bouchard	French
Boucher	French
Brisbois	French
Brodeur	French
Bureau	French
Caron	French
Cavey	French
Chaput	French
Charbonneau	French
Charpentier	French
Charron	French
Chastain	French
Chevalier	French
Chevrolet	French
Cloutier	French
Colbert	French
Comtois	French
Cornett	French
Coté	French
Coupe	French
Courtemanche	French
Cousineau	French
Couture	French
D'Aramitz	French
Daniau	French
Daviau	French
David	French
De la Fontaine	French
De Sauveterre	French
Deforest	French
DeGarmo	French
Delacroix	French
Deniau	French
Deniaud	French
Deniel	French
Denis	French
Deschamps	French
Descoteaux	French
Desjardins	French
Desrochers	French
Desrosiers	French
Dubois	French
DuChamps	French
Dufort	French
Dufour	French
Duguay	French
Dupond	French
Dupont	French
Durant	French
Duval	French
Émile	French
Eustis	French
Fabian	French
Fabre	French
Fabron	French
Faucher	French
Faucheux	French
Faure	French
Favager	French
Favre	French
Favreau	French
Félix	French
Firmin	French
Fontaine	French
Forester	French
Forestier	French
Fortier	French
Foss	French
Fournier	French
Gagne	French
Gagnier	French
Gagnon	French
Garcon	French
Gardinier	French
Germain	French
Géroux	French
Giles	French
Girard	French
Giroux	French
Glaisyer	French
Gosselin	French
Granger	French
Guérin	French
Guillory	French
Hardy	French
Harman	French
Hébert	French
Herbert	French
Herriot	French
Jacques	French
Janvier	French
Joubert	French
Labelle	French
Lachance	French
Lachapelle	French
Lambert	French
Langlais	French
Langlois	French
Lapointe	French
LaRue	French
Laurent	French
LaVigne	French
Lavoie	French
Leandres	French
LeBeau	French
LeBlanc	French
Leclair	French
Leclerc	French
Lécuyer	French
Lefebvre	French
Lefévre	French
LeFurgey	French
Legrand	French
LeMaire	French
Lémieux	French
Leon	French
Leroy	French
Lesauvage	French
Lestrange	French
Lévesque	French
Linville	French
Lyon	French
Maçon	French
Marchand	French
Marie	French
Martin	French
Mathieu	French
Mercier	French
Merle	French
Michaud	French
Monet	French
Monette	French
Montagne	French
Moreau	French
Morin	French
Mynatt	French
Oliver	French
Olivier	French
Page	French
Paget	French
Pape	French
Parent	French
Pascal	French
Patenaude	French
Pelletier	French
Perrault	French
Perreault	French
Perrot	French
Petit	French
Pettigrew	French
Pierre	French
Plamondon	French
Plourde	French
Poirier	French
Porcher	French
Poulin	French
Proulx	French
Renaud	French
Reyer	French
Richard	French
Richelieu	French
Robert	French
Roche	French
Romilly	French
Rousseau	French
Roux	French
Royer	French
S&eacute;verin	French
Salomon	French
Salvage	French
Samson	French
Samuel	French
Sargent	French
Sarkozi	French
Sarkozy	French
Sartre	French
Sauvage	French
Sauvageau	French
Sauvageon	French
Sauvageot	French
Sauveterre	French
Sergeant	French
Simon	French
Solomon	French
Soucy	French
St Martin	French
St Pierre	French
Tailler	French
Tasse	French
Thayer	French
Thibault	French
Thomas	French
Tobias	French
Tolbert	French
Travere	French
Travers	French
Traverse	French
Travert	French
Tremblay	French
Tremble	French
Victor	French
Victore	French
Victors	French
Villeneuve	French
Vipond	French
Voclain	French
Yount	French
Alkema	Frisian
Alserda	Frisian
Anema	Frisian
Anjema	Frisian
Annema	Frisian
Arkema	Frisian
Atsma	Frisian
Aukema	Frisian
Baarda	Frisian
Baarsma	Frisian
Bakema	Frisian
Barwegen	Frisian
Bootsma	Frisian
De Vries	Frisian
Dijkstra	Frisian
Herrema	Frisian
Hoekstra	Frisian
Laninga	Frisian
Reijnder	Frisian
Reijnders	Frisian
Reinder	Frisian
Reinders	Frisian
Reynder	Frisian
Reynders	Frisian
Rijnder	Frisian
Rijnders	Frisian
Van Wieren	Frisian
Abbing	German
Abel	German
Abeln	German
Achilles	German
Acker	German
Ackermann	German
Adam	German
Adenauer	German
Adler	German
Adlersflügel	German
Aeschelman	German
Albert	German
Albrecht	German
Aleshire	German
Aleshite	German
Almstedt	German
Althaus	German
Andres	German
Arisen	German
Armbruster	German
Armbrüster	German
Artz	German
Auer	German
Augustin	German
Aust	German
Autenburg	German
Auttenberg	German
B&ouml;hme	German
Baasch	German
Bach	German
Bachmeier	German
Bäcker	German
Bader	German
Bähr	German
Bambach	German
Bauer	German
Bauers	German
Baum	German
Baumann	German
Baumbach	German
Baumgartner	German
Baumgärtner	German
Baumhauer	German
Bayer	German
Becke	German
Beckenbauer	German
Becker	German
Beckert	German
Behrend	German
Behrends	German
Beitel	German
Beltz	German
Benn	German
Berg	German
Bergfalk	German
Beringer	German
Bernat	German
Best	German
Beutel	German
Beyer	German
Beyersdorf	German
Bieber	German
Biermann	German
Bischoffs	German
Blau	German
Blecher	German
Bleier	German
Blumenthal	German
Blumstein	German
Bocker	German
Boehler	German
Boer	German
Boesch	German
Böhler	German
Böhm	German
Böhmer	German
Bohn	German
Borchard	German
Bosch	German
Bösch	German
Böttcher	German
Brahms	German
Brand	German
Brandt	German
Brant	German
Brauer	German
Braun	German
Braune	German
Breiner	German
Breisacher	German
Breitbarth	German
Bretz	German
Brinkerhoff	German
Brodbeck	German
Brose	German
Brotz	German
Bruhn	German
Brun	German
Brune	German
Buchholz	German
Buckholtz	German
Buhr	German
Bumgarner	German
Burgstaller	German
Busch	German
Dahl	German
Derrick	German
Diefenbach	German
Dieter	German
Dietrich	German
Dirchs	German
Dittmar	German
Dohman	German
Drechsler	German
Dreher	German
Dreschner	German
Dresdner	German
Dressler	German
Duerr	German
Dunkle	German
Dunst	German
Dürr	German
Eberhardt	German
Eckstein	German
Egger	German
Eichel	German
Eilerts	German
Engel	German
Enns	German
Esser	German
Essert	German
Everhart	German
Fabel	German
Faerber	German
Falk	German
Falkenrath	German
Färber	German
Fashingbauer	German
Faust	German
Feigenbaum	German
Feld	German
Feldt	German
Fenstermacher	German
Fertig	German
Fiedler	German
Fischer	German
Flater	German
Fleischer	German
Foerstner	German
Forst	German
Förstner	German
Foth	German
Franke	German
Frei	German
Freud	German
Freudenberger	German
Freund	German
Fried	German
Friedrich	German
Fromm	German
Frost	German
Fuchs	German
Fuhrmann	German
Fürst	German
Gabler	German
Gaertner	German
Garb	German
Garber	German
Gärtner	German
Garver	German
Gass	German
Gehrig	German
Gehring	German
Geier	German
Geiger	German
Geisler	German
Geissler	German
Geiszler	German
Gensch	German
Gerber	German
Gerhard	German
Gerhardt	German
Gerig	German
Gerst	German
Gerstle	German
Gerver	German
Giehl	German
Giese	German
Glöckner	German
Goebel	German
Goldschmidt	German
Gott	German
Gotti	German
Gottlieb	German
Gottschalk	German
Gr&ouml;&szlig;el	German
Graner	German
Greenberg	German
Gro&szlig;	German
Gro&szlig;e	German
Gro&szlig;el	German
Gro&szlig;er	German
Groos	German
Gros	German
Gross	German
Grosse	German
Grosser	German
Grosz	German
Grünewald	German
Gunther	German
Günther	German
Gutermuth	German
Gwerder	German
Haas	German
Haase	German
Haber	German
Habich	German
Habicht	German
Hafner	German
Hahn	German
Hall	German
Harman	German
Hartmann	German
Hase	German
Hasek	German
Hasenkamp	German
Hass	German
Hauer	German
Haupt	German
Hausler	German
Havener	German
Heidrich	German
Heinrich	German
Heinrichs	German
Heintze	German
Hellewege	German
Heppenheimer	German
Herbert	German
Hermann	German
Herrmann	German
Herschel	German
Hertz	German
Hildebrand	German
Hinrichs	German
Hintzen	German
Hoch	German
Hochberg	German
Hoefler	German
Hofer	German
Hoffman	German
Hoffmann	German
Höfler	German
Hofmann	German
Hofmeister	German
Holst	German
Holtzer	German
Holzer	German
Hölzer	German
Holzknecht	German
Holzmann	German
Hoover	German
Horowitz	German
Houk	German
Huber	German
Hüber	German
Huff	German
Huffman	German
Huffmann	German
Hutmacher	German
Ingersleben	German
Jaeger	German
Jager	German
Jäger	German
Jans	German
Janson	German
Janz	German
Jollenbeck	German
Jund	German
Jung	German
Junge	German
Kahler	German
Kaiser	German
Kalb	German
Kalbfleisch	German
Kappel	German
Karl	German
Kaspar	German
Kassmeyer	German
Kästner	German
Kaube	German
Kaufer	German
Käufer	German
Kauffmann	German
Kaufman	German
Keil	German
Keller	German
Kempf	German
Kerner	German
Kerper	German
Kerwar	German
Kerwer	German
Kiefer	German
Kirchner	German
Kistler	German
Kistner	German
Kleid	German
Klein	German
Klossner	German
Knef	German
Kneib	German
Kneller	German
Knepp	German
Knochenmus	German
Knopf	German
Knopp	German
Koch	German
Kock	German
Koenig	German
Koenigsmann	German
Kohl	German
Köhl	German
Kohler	German
Köhler	German
Kolbe	German
König	German
Kopp	German
Kraemer	German
Kramer	German
Krämer	German
Krantz	German
Kranz	German
Kraus	German
Krause	German
Krauss	German
Krauß	German
Krebs	German
Kröger	German
Kron	German
Kruckel	German
Kruger	German
Küchler	German
Kuhn	German
Kundert	German
Kunkel	German
Kunkle	German
Kuntz	German
Kunze	German
Kurzmann	German
Laberenz	German
Lafrentz	German
Lafrenz	German
Landau	German
Lang	German
Lange	German
Langenberg	German
Langer	German
Larenz	German
Laurenz	German
Lauritz	German
Lawerenz	German
Lawrenz	German
Lehmann	German
Lehrer	German
Leitner	German
Leitz	German
Leitzke	German
Lenz	German
Leverenz	German
Lewerentz	German
Lewerenz	German
Lichtenberg	German
Lieberenz	German
Linden	German
Loewe	German
Lohrenz	German
Lorentz	German
Lorenz	German
Lorenzen	German
Loris	German
Loritz	German
Löwe	German
Ludwig	German
Luther	German
M&ouml;ller	German
Maas	German
Maier	German
Mandel	German
Mandelbaum	German
Mann	German
Marquering	German
Marqueringh	German
Marquerink	German
Martin	German
Martz	German
Maurer	German
Maus	German
Meier	German
Mein	German
Meindl	German
Meinhardt	German
Meisner	German
Meissner	German
Melsbach	German
Mendel	German
Mendelsohn	German
Mendelssohn	German
Messerli	German
Messmann	German
Messner	German
Metzger	German
Mohren	German
Morgenstern	German
Moser	German
Mueller	German
Muhlfeld	German
Müller	German
Nagel	German
Neuman	German
Neumann	German
Nuremberg	German
Nussbaum	German
Nussenbaum	German
Oberst	German
Oelberg	German
Ohme	German
Oliver	German
Oppenheimer	German
Otto	German
Oursler	German
Pahlke	German
Papke	German
Paulis	German
Pawlitzki	German
Penzig	German
Peter	German
Peters	German
Pfaff	German
Pfenning	German
Plank	German
Pletcher	German
Portner	German
Prinz	German
Protz	German
Rademacher	German
Rademaker	German
Raske	German
Raskob	German
Raskop	German
Raskoph	German
Regenbogen	German
Reier	German
Reiher	German
Reiter	German
Rettig	German
Richard	German
Richter	German
Rier	German
Riese	German
Ritter	German
Rosenberg	German
Rosenberger	German
Rosenfeld	German
Roth	German
Rothbauer	German
Rothenberg	German
Rothschild	German
Sachs	German
Salomon	German
Salzwedel	German
Samson	German
Samuel	German
Sander	German
Sauber	German
Schäfer	German
Scheer	German
Scheinberg	German
Schenck	German
Schermer	German
Schindler	German
Schirmer	German
Schlender	German
Schlimme	German
Schlusser	German
Schmeling	German
Schmid	German
Schmidt	German
Schmitt	German
Schmitz	German
Schnoor	German
Schnur	German
Schoettmer	German
Schrader	German
Schräder	German
Schreck	German
Schreier	German
Schroeder	German
Schroeter	German
Schröter	German
Schubert	German
Schuchard	German
Schuchardt	German
Schuchert	German
Schuhart	German
Schuhmacher	German
Schuler	German
Schult	German
Schulte	German
Schultes	German
Schultheis	German
Schultheiss	German
Schultheiß	German
Schultz	German
Schultze	German
Schulz	German
Schulze	German
Schumacher	German
Schuster	German
Schuttmann	German
Schwangau	German
Schwartz	German
Schwarz	German
Schwarzenegger	German
Schwenke	German
Schwinghammer	German
Seelenfreund	German
Seidel	German
Sheinfeld	German
Shriver	German
Siekert	German
Siemon	German
Silverstein	German
Simen	German
Simmon	German
Simon	German
Simons	German
Sinasohn	German
Siskin	German
Siskind	German
Slusser	German
Solberg	German
Sonnen	German
Sorg	German
Sorge	German
Spannagel	German
Specht	German
Spellmeyer	German
Spitznogle	German
Sponaugle	German
Stark	German
Stauss	German
Steen	German
Steffen	German
Stein	German
Steinmann	German
Stenger	German
Sternberg	German
Steube	German
Steuben	German
Stieber	German
Strand	German
Straub	German
Strobel	German
Strohkirch	German
Stroman	German
Stuber	German
Stueck	German
Stumpf	German
Sturm	German
Suess	German
Sulzbach	German
Swango	German
Switzer	German
Tangeman	German
Teufel	German
Tiedeman	German
Tifft (1)	German
Tillens	German
Tobias	German
Tolkien	German
Tresler	German
Tritten	German
Trumbauer	German
Tschida	German
Unkle	German
Unruh	German
Unterbrink	German
Ursler	German
Van Tonder	German
Venetianer	German
Victor	German
Vieth	German
Vogel	German
Vogt	German
Vogts	German
Voigt	German
Voigts	German
Volk	German
Von Brandt	German
Von Essen	German
Von Grimmelshausen	German
Von Ingersleben	German
Von Wegberg	German
Vonnegut	German
Voss	German
Wagner	German
Wägner	German
Wahner	German
Wähner	German
Waldfogel	German
Waldvogel	German
Walkenhorst	German
Walter	German
Walther	German
Waltz	German
Warner	German
Waxweiler	German
Weber	German
Wechsler	German
Wedekind	German
Weeber	German
Wegener	German
Wegner	German
Wehner	German
Wehunt	German
Weigand	German
Weiman	German
Weiner	German
Weiss	German
Weiß	German
Welter	German
Werner	German
Wernerus	German
Wernher	German
Westerberg	German
Wetterman	German
Wetzel	German
Wexler	German
Wieck	German
Wiegand	German
Wildgrube	German
Winter	German
Wirner	German
Wirnhier	German
Wirt	German
Wirth	German
Wolf	German
Wolff	German
Wolter	German
Wörner	German
Wörnhör	German
Wruck	German
Zellweger	German
Zilberschlag	German
Zimmerman	German
Zimmermann	German
Antoniou	Greek
Areleous	Greek
Argyris	Greek
Colonomos	Greek
Demetriou	Greek
Dimitriou	Greek
Floros	Greek
Ioannidis	Greek
Iordanou	Greek
Katsaros	Greek
Kokinos	Greek
Marinos	Greek
Megalos	Greek
Metaxas	Greek
Michelakakis	Greek
Michelakis	Greek
Michelakos	Greek
Pachis	Greek
Papadopoulos	Greek
Raptis	Greek
Simonides	Greek
Spiros	Greek
Stavros	Greek
Stephanidis	Greek
Xanthopoulos	Greek
Xylander	Greek
Zabat	Greek
Ádám	Hungarian
Agócs	Hungarian
Agóts	Hungarian
Albert	Hungarian
Almássy	Hungarian
Antal	Hungarian
Antall	Hungarian
Arany	Hungarian
Bajusz	Hungarian
Bakó	Hungarian
Balázs	Hungarian
Bálint	Hungarian
Balog	Hungarian
Balogh	Hungarian
Bárány	Hungarian
Baráth	Hungarian
Barna	Hungarian
Barta	Hungarian
Bartha	Hungarian
Bartos	Hungarian
Báthory	Hungarian
Bátori	Hungarian
Becskei	Hungarian
Benes	Hungarian
Bíró	Hungarian
Bodnár	Hungarian
Bodrogi	Hungarian
Bognár	Hungarian
Bokor	Hungarian
Bokori	Hungarian
Borbély	Hungarian
Boros	Hungarian
Brühn	Hungarian
Budai	Hungarian
Buday	Hungarian
Büki	Hungarian
Cinege	Hungarian
Császár	Hungarian
Cseh	Hungarian
Csintalan	Hungarian
Csizmadia	Hungarian
Csonka	Hungarian
Csorba	Hungarian
Czinege	Hungarian
Dali	Hungarian
Dobos	Hungarian
Dunai	Hungarian
Durándi	Hungarian
Eszes	Hungarian
Fábián	Hungarian
Faragó	Hungarian
Farkas	Hungarian
Fazekas	Hungarian
Fehér	Hungarian
Fejes	Hungarian
Fekete	Hungarian
Filep	Hungarian
Fodor	Hungarian
Fülöp	Hungarian
Gaál	Hungarian
Gárdonyi	Hungarian
Gáspár	Hungarian
Gereben	Hungarian
Görög	Hungarian
Graner	Hungarian
Gulyás	Hungarian
Hajós	Hungarian
Halász	Hungarian
Halmi	Hungarian
Hegedûs	Hungarian
Herceg	Hungarian
Herczeg	Hungarian
Herczog	Hungarian
Horváth	Hungarian
Ignácz	Hungarian
Illés	Hungarian
Jakab	Hungarian
Jankovics	Hungarian
Jónás	Hungarian
Juhász	Hungarian
Kádár	Hungarian
Kalmár	Hungarian
Kardos	Hungarian
Kárpáthy	Hungarian
Kárpáti	Hungarian
Kárpáty	Hungarian
Kató	Hungarian
Katona	Hungarian
Kecskeméti	Hungarian
Kedves	Hungarian
Kelemen	Hungarian
Keller	Hungarian
Kemény	Hungarian
Kerekes	Hungarian
Kertész	Hungarian
Király	Hungarian
Kiss	Hungarian
Kóbor	Hungarian
Kocsis	Hungarian
Koszorús	Hungarian
Kovách	Hungarian
Kovács	Hungarian
Kövér	Hungarian
Kurucz	Hungarian
Lakatos	Hungarian
Lantos	Hungarian
László	Hungarian
Lázár	Hungarian
Lengyel	Hungarian
Lovász	Hungarian
Lukács	Hungarian
Magyar	Hungarian
Marek	Hungarian
Markó	Hungarian
Márton	Hungarian
Meggyesfalvi	Hungarian
Mészáros	Hungarian
Molnár	Hungarian
Nagy	Hungarian
Nemes	Hungarian
Német	Hungarian
Németh	Hungarian
Novák	Hungarian
Nyilas	Hungarian
Nyitrai	Hungarian
Olasz	Hungarian
Orbán	Hungarian
Orosz	Hungarian
Pásztor	Hungarian
Pataki	Hungarian
Pesti	Hungarian
Pesty	Hungarian
Péter	Hungarian
Petes	Hungarian
Pethes	Hungarian
Pokorni	Hungarian
Prohászka	Hungarian
Puskás	Hungarian
Pusztai	Hungarian
Rigó	Hungarian
Rózsa	Hungarian
Ruzsa	Hungarian
Salomon	Hungarian
Samsa	Hungarian
Sándor	Hungarian
Sárközi	Hungarian
Sárközy	Hungarian
Sass	Hungarian
Schmidt	Hungarian
Schmitt	Hungarian
Seres	Hungarian
Simon	Hungarian
Sipos	Hungarian
Sólyom	Hungarian
Somogyi	Hungarian
Sörös	Hungarian
Sovány	Hungarian
Svéd	Hungarian
Szabó	Hungarian
Szabolcsi	Hungarian
Szántó	Hungarian
Szarka	Hungarian
Szarvas	Hungarian
Székely	Hungarian
Szekeres	Hungarian
Szép	Hungarian
Szombathy	Hungarian
Szûcs	Hungarian
Takács	Hungarian
Tamás	Hungarian
Tarr	Hungarian
Tímár	Hungarian
Tisza	Hungarian
Tolvaj	Hungarian
Tordai	Hungarian
Török	Hungarian
Tóth	Hungarian
Vadas	Hungarian
Vámos	Hungarian
Varga	Hungarian
Vargha	Hungarian
Vass	Hungarian
Vastag	Hungarian
Vastagh	Hungarian
Vencel	Hungarian
Venczel	Hungarian
Veres	Hungarian
Vida	Hungarian
Vincze	Hungarian
Virág	Hungarian
Vörös	Hungarian
Zentai	Hungarian
Zoltánfi	Hungarian
Zsoldos	Hungarian
Agnarsson	Icelandic
Anderson	Icelandic
Ármannsson	Icelandic
Heimirsson	Icelandic
Hilmarsson	Icelandic
Ingolfsson	Icelandic
Johnson	Icelandic
Leifsson	Icelandic
Nielson	Icelandic
Olvirsson	Icelandic
Robertsson	Icelandic
Sigurdsson	Icelandic
Stefansson	Icelandic
Steinsson	Icelandic
Thorirsson	Icelandic
Vilhjalmsson	Icelandic
Ahearn	Irish
Ahearne	Irish
Beirne	Irish
Berne	Irish
Boyle	Irish
Brady	Irish
Breckenridge	Irish
Breen	Irish
Brennan	Irish
Brogan	Irish
Burke	Irish
Butler	Irish
Byrne	Irish
Byrnes	Irish
Callaghan	Irish
Carey	Irish
Carmody	Irish
Casey	Irish
Cassidy	Irish
Cavanagh	Irish
Cavanah	Irish
Cavanaugh	Irish
Cleary	Irish
Clinton	Irish
Coghlan	Irish
Coleman	Irish
Connelly	Irish
Connolly	Irish
Cooney	Irish
Corcoran	Irish
Coughlan	Irish
Coughlin	Irish
Crawford	Irish
Cummins	Irish
Curran	Irish
Daley	Irish
Daly	Irish
Davin	Irish
Delaney	Irish
Delany	Irish
Dempsey	Irish
Devine	Irish
Devlin	Irish
Doherty	Irish
Dolan	Irish
Donaghue	Irish
Donne	Irish
Donnell	Irish
Donnelly	Irish
Donoghue	Irish
Donohoe	Irish
Donohue	Irish
Dougherty	Irish
Doyle	Irish
Driscoll	Irish
Duncan	Irish
Duncanson	Irish
Durnin	Irish
Fannon	Irish
Ferguson	Irish
Finn	Irish
Finnin	Irish
Fitzgerald	Irish
Fitzpatrick	Irish
Fitzsimmons	Irish
Flanagan	Irish
Flanagon	Irish
Flynn	Irish
Foley	Irish
Friel	Irish
Fylan	Irish
Gallagher	Irish
Guinness	Irish
Haden	Irish
Halloran	Irish
Hanegan	Irish
Hanigan	Irish
Hannigan	Irish
Hannigen	Irish
Heffernan	Irish
Hickey	Irish
Higgins	Irish
Hines	Irish
Hogan	Irish
Ivers	Irish
Kavanagh	Irish
Kavanah	Irish
Kavanaugh	Irish
Kearney	Irish
Kennedy	Irish
Kerry	Irish
Kilduff	Irish
Killough	Irish
Lannon	Irish
Lennon	Irish
Mac Cnáimhín	Irish
Mac Gill Fhaolain	Irish
Mac Giolla Bhrighde	Irish
Mac Giolla Eoin	Irish
Mac Naoimhín	Irish
Mac Niadh	Irish
Mac Niall	Irish
Mac Pharlain	Irish
MacBride	Irish
MacCailín	Irish
MacCarrick	Irish
MacCarthy	Irish
MacClellan	Irish
MacClelland	Irish
MacClery	Irish
MacConnell	Irish
MacCoughlan	Irish
MacDermott	Irish
MacEachthighearna	Irish
MacFarland	Irish
MacFarlane	Irish
MacGhabhann	Irish
MacGowan	Irish
MacGrory	Irish
MacGuinness	Irish
MacGuire	Irish
MacIomhair	Irish
MacIver	Irish
MacKay	Irish
MacMathan	Irish
MacNeil	Irish
MacNevin	Irish
MacQueen	Irish
MacShuibhne	Irish
Madden	Irish
Madigan	Irish
Mag Aonghuis	Irish
Magee	Irish
Maguire	Irish
Mahoney	Irish
Mallon	Irish
Malloye	Irish
Malone	Irish
Maoilseachlainn	Irish
Markey	Irish
McAdams	Irish
McCabe	Irish
McCaig	Irish
McCormick	Irish
McCracken	Irish
McCune	Irish
McElligott	Irish
McGee	Irish
McGill	Irish
McGinnis	Irish
McGuire	Irish
McKowen	Irish
McLain	Irish
McLean	Irish
McMahon	Irish
McManus	Irish
McNab	Irish
McNabb	Irish
McNamara	Irish
McNeil	Irish
McNeill	Irish
McNiadh	Irish
McNiall	Irish
McNiel	Irish
McReynolds	Irish
Meaney	Irish
Milligan	Irish
Mitchell	Irish
Moffett	Irish
Mollown	Irish
Moloney	Irish
Monaghan	Irish
Monahan	Irish
Mooney	Irish
Moriarty	Irish
Morris	Irish
Mullane	Irish
Mullen	Irish
Mulligan	Irish
Mulloy	Irish
Mulrennan	Irish
Mulryan	Irish
Munroe	Irish
Murdock	Irish
Murphy	Irish
Neville	Irish
Newell	Irish
Niven	Irish
Nolan	Irish
Ó Catháin	Irish
Ó Cnáimhín	Irish
Ó Madaidhín	Irish
Ó Máille	Irish
Ó Maol Aodha	Irish
Ó Meadhra	Irish
Ó Meara	Irish
Ó Nualláin	Irish
Ó Peatain	Irish
Ó Raghailligh	Irish
Ó Ríagáin	Irish
Ó Riain	Irish
Ó Rinn	Irish
Ó Rodagh	Irish
Ó Ruadháin	Irish
Ó Ruaidh	Irish
Ó Scolaidhe	Irish
Ó Séaghdha	Irish
Ó Seighin	Irish
Ó Síoda	Irish
Ó Suaird	Irish
Ó Taidhg	Irish
O'Beirne	Irish
O'Berne	Irish
O'Boyle	Irish
O'Brien	Irish
O'Byrne	Irish
O'Callaghan	Irish
O'Cleirigh	Irish
O'Clery	Irish
O'Connell	Irish
O'Connor	Irish
O'Donnell	Irish
O'Doyle	Irish
O'Gorman	Irish
O'Hanegan	Irish
O'Hanigan	Irish
O'Hannagain	Irish
O'Hannagan	Irish
O'Hannegan	Irish
O'Hannigain	Irish
O'Hannigan	Irish
O'Hara	Irish
O'Hearn	Irish
O'Kane	Irish
O'Keefe	Irish
O'Leary	Irish
O'Malley	Irish
O'Maoilríaghain	Irish
O'Maolmhuaidh	Irish
O'Mooney	Irish
O'Neal	Irish
O'Neill	Irish
O'Niall	Irish
O'Reilly	Irish
O'Shea	Irish
O'Sullivan	Irish
Owens	Irish
Payne	Irish
Powers	Irish
Queen	Irish
Quick	Irish
Quickley	Irish
Quigg	Irish
Quigley	Irish
Quinlan	Irish
Quinn	Irish
Quirk	Irish
Quirke	Irish
Regan	Irish
Reilly	Irish
Rice	Irish
Roche	Irish
Rowan	Irish
Rowe	Irish
Ruane	Irish
Ryan	Irish
Sams	Irish
Scully	Irish
Shannon	Irish
Sheach	Irish
Sheedy	Irish
Sheehy	Irish
Sheenan	Irish
Sheridan	Irish
Slane	Irish
Sloan	Irish
Sloane	Irish
Sullivan	Irish
Taggart	Irish
Tierney	Irish
Tighe	Irish
Tracy	Irish
Treacy	Irish
Wallace	Irish
Walsh	Irish
Whalen	Irish
Whelan	Irish
Abandonato	Italian
Abatangelo	Italian
Abatantuono	Italian
Abate	Italian
Abategiovanni	Italian
Abatescianni	Italian
Abbà	Italian
Abbadelli	Italian
Abbascia	Italian
Abbatangelo	Italian
Abbatantuono	Italian
Abbate	Italian
Abbatelli	Italian
Abbaticchio	Italian
Abbiati	Italian
Abbracciabene	Italian
Abbracciabeni	Italian
Abelli	Italian
Abelló	Italian
Abrami	Italian
Abramo	Italian
Acardi	Italian
Accardi	Italian
Accardo	Italian
Acciai	Italian
Acciaio	Italian
Acciaioli	Italian
Acconci	Italian
Acconcio	Italian
Accorsi	Italian
Accorso	Italian
Accosi	Italian
Accursio	Italian
Acerbi	Italian
Acone	Italian
Aconi	Italian
Acqua	Italian
Acquafredda	Italian
Acquarone	Italian
Acquati	Italian
Adalardi	Italian
Adam	Italian
Adami	Italian
Adamo	Italian
Adamoli	Italian
Addario	Italian
Adelardi	Italian
Adessi	Italian
Adimari	Italian
Adriatico	Italian
Affini	Italian
Africani	Italian
Africano	Italian
Agani	Italian
Aggi	Italian
Aggio	Italian
Agli	Italian
Agnelli	Italian
Agnellutti	Italian
Agnusdei	Italian
Agosti	Italian
Agostini	Italian
Agresta	Italian
Agrioli	Italian
Aiello	Italian
Aiolfi	Italian
Airaldi	Italian
Airò	Italian
Aita	Italian
Ajello	Italian
Alagona	Italian
Alamanni	Italian
Albanesi	Italian
Albani	Italian
Albano	Italian
Alberghi	Italian
Alberghini	Italian
Alberici	Italian
Alberighi	Italian
Albero	Italian
Albini	Italian
Albricci	Italian
Albrici	Italian
Alcheri	Italian
Aldebrandi	Italian
Alderisi	Italian
Alduino	Italian
Alemagna	Italian
Aleppo	Italian
Alesci	Italian
Alescio	Italian
Alesi	Italian
Alesini	Italian
Alesio	Italian
Alessandri	Italian
Alessi	Italian
Alfero	Italian
Aliberti	Italian
Alinari	Italian
Aliprandi	Italian
Allegri	Italian
Allegro	Italian
Aloia	Italian
Aloisi	Italian
Altamura	Italian
Altimari	Italian
Altoviti	Italian
Alunni	Italian
Amadei	Italian
Amadori	Italian
Amalberti	Italian
Amantea	Italian
Amato	Italian
Amatore	Italian
Ambrogi	Italian
Ambrosi	Italian
Amello	Italian
Amerighi	Italian
Amoretto	Italian
Angioli	Italian
Ansaldi	Italian
Anselmetti	Italian
Anselmi	Italian
Antonelli	Italian
Antonini	Italian
Antonino	Italian
Aquila	Italian
Aquino	Italian
Arbore	Italian
Ardiccioni	Italian
Ardizzone	Italian
Ardovini	Italian
Arena	Italian
Aringheri	Italian
Arlotti	Italian
Armani	Italian
Armati	Italian
Armonni	Italian
Arnolfi	Italian
Arnoni	Italian
Arrighetti	Italian
Arrighi	Italian
Arrigucci	Italian
Aucciello	Italian
Azzarà	Italian
Baggi	Italian
Baggio	Italian
Baglio	Italian
Bagni	Italian
Bagnoli	Italian
Balboni	Italian
Baldi	Italian
Baldini	Italian
Baldinotti	Italian
Baldovini	Italian
Bandini	Italian
Bandoni	Italian
Barbieri	Italian
Barone	Italian
Barsetti	Italian
Bartalotti	Italian
Bartolomei	Italian
Bartolomeo	Italian
Barzetti	Italian
Basile	Italian
Bassanelli	Italian
Bassani	Italian
Bassi	Italian
Basso	Italian
Basurto	Italian
Battaglia	Italian
Bazzoli	Italian
Bellandi	Italian
Bellandini	Italian
Bellincioni	Italian
Bellini	Italian
Bello	Italian
Bellomi	Italian
Belloni	Italian
Belluomi	Italian
Belmonte	Italian
Bencivenni	Italian
Benedetti	Italian
Benenati	Italian
Benetton	Italian
Benini	Italian
Benivieni	Italian
Benvenuti	Italian
Berardi	Italian
Bergamaschi	Italian
Berti	Italian
Bertolini	Italian
Biancardi	Italian
Bianchi	Italian
Bicchieri	Italian
Biondi	Italian
Biondo	Italian
Boerio	Italian
Bologna	Italian
Bondesan	Italian
Bonomo	Italian
Borghi	Italian
Borgnino	Italian
Borgogni	Italian
Bosco	Italian
Bove	Italian
Bovér	Italian
Boveri	Italian
Brambani	Italian
Brambilla	Italian
Breda	Italian
Brioschi	Italian
Brivio	Italian
Brunetti	Italian
Bruno	Italian
Buffone	Italian
Bulgarelli	Italian
Bulgari	Italian
Buonarroti	Italian
Busto	Italian
Caiazzo	Italian
Caito	Italian
Caivano	Italian
Calabrese	Italian
Calligaris	Italian
Campana	Italian
Campo	Italian
Cantu	Italian
Capitani	Italian
Carbone	Italian
Carboni	Italian
Carideo	Italian
Carlevaro	Italian
Caro	Italian
Carracci	Italian
Carrara	Italian
Caruso	Italian
Cassano	Italian
Castro	Italian
Catalano	Italian
Cattaneo	Italian
Cavalcante	Italian
Cavallo	Italian
Cingolani	Italian
Cino	Italian
Cipriani	Italian
Cisternino	Italian
Coiro	Italian
Cola	Italian
Colombera	Italian
Colombo	Italian
Columbo	Italian
Confortola	Italian
Conti	Italian
Corna	Italian
Corti	Italian
Corvi	Italian
Costa	Italian
Costantini	Italian
Costanzo	Italian
Cracchiolo	Italian
Cremaschi	Italian
Cremona	Italian
Cremonesi	Italian
Crespo	Italian
Croce	Italian
Crocetti	Italian
Cucinotta	Italian
Cuocco	Italian
Cuoco	Italian
D'Ambrosio	Italian
D'Amore	Italian
D'Angelo	Italian
D'Antonio	Italian
D'Onofrio	Italian
Damiani	Italian
De Angelis	Italian
De Campo	Italian
De Felice	Italian
De Filippis	Italian
De Fiore	Italian
De Laurentis	Italian
De Luca	Italian
De Palma	Italian
De Rege	Italian
De Santis	Italian
De Vitis	Italian
Di Antonio	Italian
Di Caprio	Italian
Di Mercurio	Italian
Di Pasqua	Italian
Di Pietro	Italian
Di Stefano	Italian
Dinapoli	Italian
Dioli	Italian
Donati	Italian
Drago	Italian
Durante	Italian
Elena	Italian
Episcopo	Italian
Ermacora	Italian
Esposito	Italian
Evangelista	Italian
Fabbri	Italian
Fabbro	Italian
Falco	Italian
Faraldo	Italian
Farina	Italian
Farro	Italian
Fattore	Italian
Fausti	Italian
Fava	Italian
Favero	Italian
Fermi	Italian
Ferrara	Italian
Ferrari	Italian
Ferraro	Italian
Ferrero	Italian
Ferro	Italian
Fierro	Italian
Filippi	Italian
Fini	Italian
Fiore	Italian
Fonda	Italian
Fontana	Italian
Fortunato	Italian
Franco	Italian
Franzese	Italian
Furlan	Italian
Gabrielli	Italian
Gagliardi	Italian
Gallo	Italian
Ganza	Italian
Garfagnini	Italian
Garofalo	Italian
Gaspari	Italian
Gatti	Italian
Genovese	Italian
Gentile	Italian
Germano	Italian
Giannino	Italian
Gimondi	Italian
Giordano	Italian
Gismondi	Italian
Giùgovaz	Italian
Giunta	Italian
Gori	Italian
Greco	Italian
Grillo	Italian
Grimaldi	Italian
Gronchi	Italian
Guarneri	Italian
Guerra	Italian
Guerriero	Italian
Guidi	Italian
Guttuso	Italian
Idoni	Italian
Innocenti	Italian
Labriola	Italian
Làconi	Italian
Laganà	Italian
Lagomarsìno	Italian
Lagorio	Italian
Laguardia	Italian
Lama	Italian
Lamberti	Italian
Lamon	Italian
Landi	Italian
Lando	Italian
Landolfi	Italian
Laterza	Italian
Laurito	Italian
Lazzari	Italian
Lecce	Italian
Leccese	Italian
Leggièri	Italian
Lèmmi	Italian
Leone	Italian
Leoni	Italian
Lippi	Italian
Locatelli	Italian
Lombardi	Italian
Longo	Italian
Lupo	Italian
Luzzatto	Italian
Maestri	Italian
Magro	Italian
Mancini	Italian
Manco	Italian
Mancuso	Italian
Manfredi	Italian
Manfredonia	Italian
Mantovani	Italian
Marchegiano	Italian
Marchesi	Italian
Marchetti	Italian
Marchioni	Italian
Marconi	Italian
Mari	Italian
Maria	Italian
Mariani	Italian
Marino	Italian
Marmo	Italian
Martelli	Italian
Martinelli	Italian
Masi	Italian
Masin	Italian
Maurell	Italian
Mazza	Italian
Merlo	Italian
Messana	Italian
Micheli	Italian
Milani	Italian
Milano	Italian
Modugno	Italian
Mondadori	Italian
Mondo	Italian
Montagna	Italian
Montana	Italian
Montanari	Italian
Monte	Italian
Monti	Italian
Morandi	Italian
Moretti	Italian
Morra	Italian
Moschella	Italian
Mosconi	Italian
Motta	Italian
Muggia	Italian
Muraro	Italian
Murgia	Italian
Murtas	Italian
Nacar	Italian
Naggi	Italian
Naggia	Italian
Naldi	Italian
Nana	Italian
Nani	Italian
Nanni	Italian
Nannini	Italian
Napoleoni	Italian
Napoletani	Italian
Napoliello	Italian
Nardi	Italian
Nardo	Italian
Nardovino	Italian
Nasato	Italian
Nascimbene	Italian
Nascimbeni	Italian
Natale	Italian
Nave	Italian
Nazario	Italian
Necchi	Italian
Negri	Italian
Negrini	Italian
Nelli	Italian
Nenci	Italian
Nepi	Italian
Neri	Italian
Neroni	Italian
Nervetti	Italian
Nervi	Italian
Nespola	Italian
Nicastro	Italian
Nicchi	Italian
Nicodemo	Italian
Nicolai	Italian
Nicolosi	Italian
Nicosia	Italian
Nicotera	Italian
Nieddu	Italian
Nieri	Italian
Nigro	Italian
Nisi	Italian
Nizzola	Italian
Noschese	Italian
Notaro	Italian
Notoriano	Italian
Oberti	Italian
Oberto	Italian
Ongaro	Italian
Orlando	Italian
Orsini	Italian
Pace	Italian
Padovan	Italian
Padovano	Italian
Pagani	Italian
Pagano	Italian
Palladino	Italian
Palmisano	Italian
Palumbo	Italian
Panzavecchia	Italian
Parisi	Italian
Parma	Italian
Parodi	Italian
Parri	Italian
Parrino	Italian
Passerini	Italian
Pastore	Italian
Paternoster	Italian
Pavesi	Italian
Pavone	Italian
Pavoni	Italian
Pecora	Italian
Pedrotti	Italian
Pellegrino	Italian
Perugia	Italian
Pesaresi	Italian
Pesaro	Italian
Pesce	Italian
Petri	Italian
Pherigo	Italian
Piazza	Italian
Piccirillo	Italian
Piccoli	Italian
Pierno	Italian
Pietri	Italian
Pini	Italian
Piovene	Italian
Piraino	Italian
Pisani	Italian
Pittaluga	Italian
Poggi	Italian
Poggio	Italian
Poletti	Italian
Pontecorvo	Italian
Portelli	Italian
Porto	Italian
Portoghese	Italian
Potenza	Italian
Pozzi	Italian
Profeta	Italian
Prosdocimi	Italian
Provenza	Italian
Provenzano	Italian
Pugliese	Italian
Quaranta	Italian
Quattrocchi	Italian
Ragno	Italian
Raimondi	Italian
Rais	Italian
Rana	Italian
Raneri	Italian
Rapallino	Italian
Ratti	Italian
Ravenna	Italian
Ricchetti	Italian
Ricci	Italian
Riggi	Italian
Righi	Italian
Rinaldi	Italian
Riva	Italian
Rizzo	Italian
Robustelli	Italian
Rocca	Italian
Rocchi	Italian
Rocco	Italian
Romagna	Italian
Romagnoli	Italian
Roncalli	Italian
Ronchi	Italian
Rosa	Italian
Rossi	Italian
Rossini	Italian
Rotolo	Italian
Rovigatti	Italian
Ruggeri	Italian
Russo	Italian
Rustici	Italian
Ruzzier	Italian
Sabbadin	Italian
Sacco	Italian
Sala	Italian
Salucci	Italian
Salvaggi	Italian
Salvai	Italian
Salvail	Italian
Salvatici	Italian
Salvay	Italian
Sansone	Italian
Santini	Italian
Santoro	Italian
Sapienti	Italian
Sarno	Italian
Sarti	Italian
Sartini	Italian
Sarto	Italian
Savona	Italian
Scarpa	Italian
Scarsi	Italian
Scavo	Italian
Sciacca	Italian
Sciacchitano	Italian
Sciarra	Italian
Scordato	Italian
Scotti	Italian
Scutese	Italian
Sebastiani	Italian
Sebastino	Italian
Segreti	Italian
Selmone	Italian
Selvaggio	Italian
Serafin	Italian
Serafini	Italian
Serpico	Italian
Sessa	Italian
Sgro	Italian
Siena	Italian
Silvestri	Italian
Soldati	Italian
Somma	Italian
Sordi	Italian
Soriano	Italian
Sorrentino	Italian
Spada	Italian
Spanò	Italian
Sparacello	Italian
Speziale	Italian
Spini	Italian
Stabile	Italian
Stablum	Italian
Stilo	Italian
Sultana	Italian
Tafani	Italian
Tamàro	Italian
Tamboia	Italian
Tanzi	Italian
Tarantino	Italian
Taverna	Italian
Tedesco	Italian
Terranova	Italian
Tessaro	Italian
Testa	Italian
Tiraboschi	Italian
Tivoli	Italian
Todaro	Italian
Toloni	Italian
Tornincasa	Italian
Toselli	Italian
Tosetti	Italian
Tosi	Italian
Tosto	Italian
Trapani	Italian
Traversa	Italian
Traversi	Italian
Traversini	Italian
Traverso	Italian
Trucco	Italian
Trudu	Italian
Tumicelli	Italian
Turati	Italian
Turchi	Italian
Uberti	Italian
Uccello	Italian
Uggeri	Italian
Ughi	Italian
Ungaretti	Italian
Ungaro	Italian
Vacca	Italian
Vaccaro	Italian
Valenti	Italian
Valentini	Italian
Valerio	Italian
Varano	Italian
Venetianer	Italian
Ventimiglia	Italian
Ventura	Italian
Verona	Italian
Veronesi	Italian
Vescovi	Italian
Vespa	Italian
Vestri	Italian
Vicario	Italian
Vico	Italian
Victor	Italian
Victore	Italian
Vigo	Italian
Villa	Italian
Viola	Italian
Vitali	Italian
Viteri	Italian
Voltolini	Italian
Zanetti	Italian
Zangari	Italian
Zappa	Italian
Zeni	Italian
Zini	Italian
Zino	Italian
Zunino	Italian
Akiyama	Japanese
Fujimoto	Japanese
Fujioka	Japanese
Fukui	Japanese
Hamasaki	Japanese
Hashimoto	Japanese
Hayashi	Japanese
Himura	Japanese
Hisakawa	Japanese
Honda	Japanese
Inoue	Japanese
Kagome	Japanese
Kato	Japanese
Kawaguchi	Japanese
Kimura	Japanese
Kita	Japanese
Kobayashi	Japanese
Koizumi	Japanese
Kurosawa	Japanese
Maki	Japanese
Matsumoto	Japanese
Matsuoka	Japanese
Matsushita	Japanese
Minami	Japanese
Miyamoto	Japanese
Mizushima	Japanese
Mori	Japanese
Motou	Japanese
Nakahara	Japanese
Nakamura	Japanese
Nakano	Japanese
Nishimura	Japanese
Oshiro	Japanese
Saito	Japanese
Shizuka	Japanese
Suzuki	Japanese
Tachibana	Japanese
Takahashi	Japanese
Takenaka	Japanese
Tanaka	Japanese
Tsukino	Japanese
Tsukuda	Japanese
Ueda	Japanese
Ueno	Japanese
Wakahisa	Japanese
Watanabe	Japanese
Yamada	Japanese
Yamaguchi	Japanese
Yamamoto	Japanese
Yamauchi	Japanese
Yoshida	Japanese
Yukimura	Japanese
Aaron	Hebrew
Amos	Hebrew
Avraham	Hebrew
Bachman	Hebrew
Baum	Hebrew
Baumann	Hebrew
Berkovich	Hebrew
Berkowicz	Hebrew
Berkowitz	Hebrew
Bieber	Hebrew
Blum	Hebrew
Blumenthal	Hebrew
Blumstein	Hebrew
Böhmer	Hebrew
Briefman	Hebrew
Chaikin	Hebrew
Cohen	Hebrew
David	Hebrew
Espinosa	Hebrew
Ezra	Hebrew
Feigenbaum	Hebrew
Feld	Hebrew
Feldt	Hebrew
Fermi	Hebrew
Fisher	Hebrew
Gass	Hebrew
Goldhirsch	Hebrew
Greenberg	Hebrew
Greenspan	Hebrew
Haber	Hebrew
Harel	Hebrew
Herschel	Hebrew
Hershey	Hebrew
Hochberg	Hebrew
Horowitz	Hebrew
Jäger	Hebrew
Kaminski	Hebrew
Kauffmann	Hebrew
Kaufman	Hebrew
Kleid	Hebrew
Klein	Hebrew
Krakowski	Hebrew
Kramer	Hebrew
Krantz	Hebrew
Kravitz	Hebrew
Landau	Hebrew
Langer	Hebrew
Lehrer	Hebrew
Levi	Hebrew
Levine	Hebrew
Luzzatto	Hebrew
Maier	Hebrew
Maksimov	Hebrew
Mandel	Hebrew
Mandelbaum	Hebrew
Markovic	Hebrew
Matos	Hebrew
Meier	Hebrew
Meir	Hebrew
Mencher	Hebrew
Mendel	Hebrew
Mendelsohn	Hebrew
Mendelssohn	Hebrew
Moses	Hebrew
Neuman	Hebrew
Novak	Hebrew
Nussbaum	Hebrew
Nussenbaum	Hebrew
Östberg	Hebrew
Pascal	Hebrew
Pasternack	Hebrew
Pasternak	Hebrew
Pontecorvo	Hebrew
Prinz	Hebrew
Regenbogen	Hebrew
Reis	Hebrew
Riese	Hebrew
Rosenberg	Hebrew
Rosenberger	Hebrew
Rosenfeld	Hebrew
Roth	Hebrew
Rothenberg	Hebrew
Rothschild	Hebrew
Salomon	Hebrew
Samson	Hebrew
Samuel	Hebrew
Scheinberg	Hebrew
Schenck	Hebrew
Schindler	Hebrew
Schnur	Hebrew
Schreier	Hebrew
Schwarz	Hebrew
Seelenfreund	Hebrew
Seidel	Hebrew
Shafir	Hebrew
Shain	Hebrew
Shapiro	Hebrew
Sheinfeld	Hebrew
Silverstein	Hebrew
Simon	Hebrew
Sinasohn	Hebrew
Siskin	Hebrew
Siskind	Hebrew
Sobol	Hebrew
Sokol	Hebrew
Sokoll	Hebrew
Sokolof	Hebrew
Sokolofsky	Hebrew
Sokolsky	Hebrew
Solomon	Hebrew
Spitznogle	Hebrew
Stein	Hebrew
Stolarz	Hebrew
Stueck	Hebrew
Suess	Hebrew
Tobias	Hebrew
Toledano	Hebrew
Venetianer	Hebrew
Waldfogel	Hebrew
Waldvogel	Hebrew
Wechsler	Hebrew
Wexler	Hebrew
Wirth	Hebrew
Wolff	Hebrew
Zilberschlag	Hebrew
Zimman	Hebrew
Zimmermann	Hebrew
Zingel	Hebrew
Han	Korean
Kim	Korean
Kwan	Korean
Lee	Korean
Li	Korean
Moon	Korean
Rhee	Korean
Song	Korean
Yi	Korean
Yu	Korean
Astrauckas	Lithuanian
Simoneit	Lithuanian
Simonis	Lithuanian
Abdullah	Arabic
Abujamal	Arabic
Ahmad	Arabic
Ahmed	Arabic
Ajam	Arabic
AlBaf	Arabic
Alfarsi	Arabic
Boulos	Arabic
Bousaid	Arabic
Darzi	Arabic
Hakim	Arabic
Hussain	Arabic
Karim	Arabic
Karimi	Arabic
Mohammed	Arabic
Muhammad	Arabic
Nagi	Arabic
Nejem	Arabic
Saab	Arabic
Samara	Arabic
Sultan	Arabic
Zaman	Arabic
Abel	Norwegian
Abrahamsen	Norwegian
Abrahamssen	Norwegian
Abrahamsson	Norwegian
Abramsen	Norwegian
Abramssen	Norwegian
Abramsson	Norwegian
Adamsen	Norwegian
Adamssen	Norwegian
Adamsson	Norwegian
Albertsen	Norwegian
Andersen	Norwegian
Arnesen	Norwegian
Arthursen	Norwegian
Arthurson	Norwegian
Arthurssen	Norwegian
Arthursson	Norwegian
Årud	Norwegian
Baardsson	Norwegian
Bernardsen	Norwegian
Bernardssen	Norwegian
Bernardsson	Norwegian
Carlson	Norwegian
Christiansen	Norwegian
Dahl	Norwegian
Elmersen	Norwegian
Elmerson	Norwegian
Elmerssen	Norwegian
Elmersson	Norwegian
Erickson	Norwegian
Falk	Norwegian
Gulbrandsen	Norwegian
Hagebak	Norwegian
Hall	Norwegian
Haraldsson	Norwegian
Haugen	Norwegian
Herbertsen	Norwegian
Herbertson	Norwegian
Herbertssen	Norwegian
Herbertsson	Norwegian
Hermansen	Norwegian
Hermanson	Norwegian
Hermanssen	Norwegian
Hermansson	Norwegian
Holt	Norwegian
Jacobson	Norwegian
Jakobsen	Norwegian
Knutsen	Norwegian
Knutson	Norwegian
Landvik	Norwegian
Lang	Norwegian
Lange	Norwegian
Leifsson	Norwegian
Leonardsen	Norwegian
Leonardson	Norwegian
Leonardssen	Norwegian
Leonardsson	Norwegian
Losnedahl	Norwegian
Lund	Norwegian
Naess	Norwegian
Næss	Norwegian
Nass	Norwegian
Ness	Norwegian
Nielsen	Norwegian
Nilsen	Norwegian
Normansen	Norwegian
Normanson	Norwegian
Normanssen	Norwegian
Normansson	Norwegian
Olhouser	Norwegian
Oliversen	Norwegian
Oliverson	Norwegian
Oliverssen	Norwegian
Oliversson	Norwegian
Omdahl	Norwegian
Ostberg	Norwegian
Ovesen	Norwegian
Raske	Norwegian
Rasmussen	Norwegian
Robertsson	Norwegian
Rolvsson	Norwegian
Rupertsen	Norwegian
Rupertson	Norwegian
Rupertssen	Norwegian
Rupertsson	Norwegian
Salomon	Norwegian
Sinason	Norwegian
Skjeggestad	Norwegian
Solberg	Norwegian
Sørensen	Norwegian
Spillum	Norwegian
Steensen	Norwegian
Storstrand	Norwegian
Strand	Norwegian
Swenhaugen	Norwegian
Tennfjord	Norwegian
Toov	Norwegian
Victorsen	Norwegian
Victorson	Norwegian
Victorsson	Norwegian
Vilhjalmsson	Norwegian
Vinter	Norwegian
Vollan	Norwegian
Waltersen	Norwegian
Walterson	Norwegian
Walterssen	Norwegian
Waltersson	Norwegian
Wolff	Norwegian
Adamczak	Polish
Adamczyk	Polish
Andrysiak	Polish
Auttenberg	Polish
Bartosz	Polish
Bernard	Polish
Bobienski	Polish
Bosko	Polish
Brzezicki	Polish
Budny	Polish
Bukoski	Polish
Bukowski	Polish
Chlebek	Polish
Chmiel	Polish
Czajka	Polish
Czajkowski	Polish
Dubanowski	Polish
Dubicki	Polish
Dunajski	Polish
Dziedzic	Polish
Fabian	Polish
Filipek	Polish
Filipowski	Polish
Gajos	Polish
Gniewek	Polish
Gomolka	Polish
Gomulka	Polish
Gorecki	Polish
Górka	Polish
Gorski	Polish
Grzeskiewicz	Polish
Gwozdek	Polish
Jagoda	Polish
Janda	Polish
Janowski	Polish
Jaskolski	Polish
Jaskulski	Polish
Jedynak	Polish
Jelen	Polish
Kaczka	Polish
Kaluza	Polish
Kaminski	Polish
Kasprzak	Polish
Kava	Polish
Kedzierski	Polish
Kijek	Polish
Klimek	Polish
Kosmatka	Polish
Kovár	Polish
Kowalczyk	Polish
Kowalski	Polish
Koziol	Polish
Kozlow	Polish
Kozlowski	Polish
Krakowski	Polish
Król	Polish
Kumiega	Polish
Lawniczak	Polish
Majewski	Polish
Malinowski	Polish
Maly	Polish
Marek	Polish
Marszalek	Polish
Maslanka	Polish
Mencher	Polish
Miazga	Polish
Mikolajczak	Polish
Mozdzierz	Polish
Musil	Polish
Niemczyk	Polish
Niemec	Polish
Nosek	Polish
Novak	Polish
Nowak	Polish
Pakulski	Polish
Pasternack	Polish
Pasternak	Polish
Paszek	Polish
Piatek	Polish
Piontek	Polish
Pokorny	Polish
Poplawski	Polish
Rudaski	Polish
Rudawski	Polish
Rusnak	Polish
Rutkowski	Polish
Sadowski	Polish
Salomon	Polish
Serafin	Polish
Sienkiewicz	Polish
Sierzant	Polish
Sitko	Polish
Skala	Polish
Slaski	Polish
Slazak	Polish
Slusarczyk	Polish
Slusarski	Polish
Smolák	Polish
Sniegowski	Polish
Sobol	Polish
Sokal	Polish
Sokolof	Polish
Sokolofsky	Polish
Sokolowski	Polish
Sokolsky	Polish
Sówka	Polish
Starek	Polish
Stawski	Polish
Stolarz	Polish
Szczepanski	Polish
Szewc	Polish
Szwarc	Polish
Szweda	Polish
Szwedko	Polish
Walentowicz	Polish
Warszawski	Polish
Wawrzaszek	Polish
Wiater	Polish
Winograd	Polish
Winogrodzki	Polish
Wojda	Polish
Wojewódka	Polish
Wojewódzki	Polish
Wronski	Polish
Wyrick	Polish
Wyrzyk	Polish
Zabek	Polish
Zawisza	Polish
Zielinski	Polish
Ziemniak	Polish
Zientek	Polish
Zuraw	Polish
Abreu	Portuguese
Achilles	Portuguese
Albuquerque	Portuguese
Almeida	Portuguese
Alves	Portuguese
Araújo	Portuguese
Araullo	Portuguese
Barros	Portuguese
Basurto	Portuguese
Belo	Portuguese
Cabral	Portuguese
Campos	Portuguese
Cardozo	Portuguese
Castro	Portuguese
Coelho	Portuguese
Costa	Portuguese
Crespo	Portuguese
Cruz	Portuguese
D'Cruz	Portuguese
D'Cruze	Portuguese
De Santigo	Portuguese
Delgado	Portuguese
Duarte	Portuguese
Estéves	Portuguese
Fernandes	Portuguese
Ferro	Portuguese
Fonseca	Portuguese
Franco	Portuguese
Freitas	Portuguese
Garcia	Portuguese
Gaspar	Portuguese
Gomes	Portuguese
Gouveia	Portuguese
Guerra	Portuguese
Henriques	Portuguese
Lobo	Portuguese
Machado	Portuguese
Magalhães	Portuguese
Maria	Portuguese
Mata	Portuguese
Mateus	Portuguese
Matos	Portuguese
Medeiros	Portuguese
Melo	Portuguese
Mendes	Portuguese
Moreno	Portuguese
Nunes	Portuguese
Palmeiro	Portuguese
Paredes	Portuguese
Pereira	Portuguese
Pinheiro	Portuguese
Pinho	Portuguese
Ribeiro	Portuguese
Rios	Portuguese
Rocha	Portuguese
Rodrigues	Portuguese
Romão	Portuguese
Rosario	Portuguese
Salazar	Portuguese
Santana	Portuguese
Santiago	Portuguese
Santos	Portuguese
Serafim	Portuguese
Silva	Portuguese
Silveira	Portuguese
Simões	Portuguese
Soares	Portuguese
Souza	Portuguese
Torres	Portuguese
Vargas	Portuguese
Ventura	Portuguese
Victor	Portuguese
Victore	Portuguese
Albescu	Romanian
Albu	Romanian
Alexandrescu	Romanian
Anghelescu	Romanian
Antonescu	Romanian
Ardelean	Romanian
Cojocaru	Romanian
Constantin	Romanian
Constantinescu	Romanian
Dalca	Romanian
Dumitrescu	Romanian
Dumitru	Romanian
Funar	Romanian
Gabor	Romanian
Grigorescu	Romanian
Iliescu	Romanian
Ionesco	Romanian
Ionescu	Romanian
Lungu	Romanian
Lupei	Romanian
Negrescu	Romanian
Nicolescu	Romanian
Petran	Romanian
Petrescu	Romanian
Popescu	Romanian
Sala	Romanian
Serban	Romanian
Ungur	Romanian
Vãduva	Romanian
Vasile	Romanian
Vasilescu	Romanian
Vladimirescu	Romanian
Alkaev	Russian
Bogomolov	Russian
Filipov	Russian
Fyodorov	Russian
Ivanov	Russian
Kaminski	Russian
Konstantinov	Russian
Kozlov	Russian
Krupin	Russian
Kuznetsov	Russian
Lagounov	Russian
Lagunov	Russian
Maksimov	Russian
Markovic	Russian
Matveev	Russian
Mihaylov	Russian
Mikhailov	Russian
Orlov	Russian
Pajari	Russian
Pasternack	Russian
Pasternak	Russian
Pavlov	Russian
Petrov	Russian
Polzin	Russian
Popov	Russian
Romanov	Russian
Sokoll	Russian
Sokolof	Russian
Sokolov	Russian
Utkin	Russian
Vasilyev	Russian
Volkov	Russian
Yakovlev	Russian
Zolnerowich	Russian
Abel	Scandinavian
Abrahamsen	Scandinavian
Abrahamssen	Scandinavian
Abrahamsson	Scandinavian
Abramsen	Scandinavian
Abramssen	Scandinavian
Abramsson	Scandinavian
Adamsen	Scandinavian
Adamssen	Scandinavian
Adamsson	Scandinavian
Adolfsson	Scandinavian
Adolvsson	Scandinavian
Agnarsson	Scandinavian
Ahlberg	Scandinavian
Ahlgren	Scandinavian
Ahlström	Scandinavian
Akselsen	Scandinavian
Albertsen	Scandinavian
Albertson	Scandinavian
Albertsson	Scandinavian
Albinson	Scandinavian
Albinsson	Scandinavian
Albrechtsson	Scandinavian
Albrecktsson	Scandinavian
Albrektson	Scandinavian
Albrektsson	Scandinavian
Alexandersen	Scandinavian
Alexanderson	Scandinavian
Alexandersson	Scandinavian
Alfredsson	Scandinavian
Alfsson	Scandinavian
Almstedt	Scandinavian
Alvarsson	Scandinavian
Andersen	Scandinavian
Anderson	Scandinavian
Andersson	Scandinavian
Andreasen	Scandinavian
Andreasson	Scandinavian
Andréasson	Scandinavian
Anthonsen	Scandinavian
Antonsen	Scandinavian
Ármannsson	Scandinavian
Arnesen	Scandinavian
Arthursen	Scandinavian
Arthurson	Scandinavian
Arthurssen	Scandinavian
Arthursson	Scandinavian
Årud	Scandinavian
Axelsen	Scandinavian
Axelsson	Scandinavian
Baardsson	Scandinavian
Bager	Scandinavian
Bendtsen	Scandinavian
Bengtsdotter	Scandinavian
Bengtsson	Scandinavian
Bentsen	Scandinavian
Berg	Scandinavian
Bergfalk	Scandinavian
Bergman	Scandinavian
Bergström	Scandinavian
Bernardsen	Scandinavian
Bernardssen	Scandinavian
Bernardsson	Scandinavian
Bjarnesen	Scandinavian
Björk	Scandinavian
Bjorkman	Scandinavian
Björnsson	Scandinavian
Blom	Scandinavian
Blomgren	Scandinavian
Bodilsen	Scandinavian
Borg	Scandinavian
Byquist	Scandinavian
Byström	Scandinavian
Carlsen	Scandinavian
Carlson	Scandinavian
Carstensen	Scandinavian
Christensen	Scandinavian
Christiansen	Scandinavian
Christoffersen	Scandinavian
Claesson	Scandinavian
Clausen	Scandinavian
Clemensen	Scandinavian
Dahl	Scandinavian
Danielsen	Scandinavian
Danielsson	Scandinavian
Davidsen	Scandinavian
Doctor	Scandinavian
Einarsson	Scandinavian
Eklund	Scandinavian
Elmersen	Scandinavian
Elmerson	Scandinavian
Elmerssen	Scandinavian
Elmersson	Scandinavian
Engberg	Scandinavian
Engman	Scandinavian
Engström	Scandinavian
Erickson	Scandinavian
Ericson	Scandinavian
Eriksen	Scandinavian
Eriksson	Scandinavian
Falk	Scandinavian
Fisker	Scandinavian
Frederiksen	Scandinavian
Frisk	Scandinavian
Gerhardsson	Scandinavian
Giese	Scandinavian
Göransson	Scandinavian
Grahn	Scandinavian
Gulbrandsen	Scandinavian
Guldbrandsen	Scandinavian
Gunnarsen	Scandinavian
Gunnarsson	Scandinavian
Gunvaldsson	Scandinavian
Gustafsson	Scandinavian
Haakonsson	Scandinavian
Hagebak	Scandinavian
Hall	Scandinavian
Hallman	Scandinavian
Hansson	Scandinavian
Haraldsson	Scandinavian
Haugen	Scandinavian
Heimirsson	Scandinavian
Henningsen	Scandinavian
Henriksen	Scandinavian
Herbertsen	Scandinavian
Herbertson	Scandinavian
Herbertssen	Scandinavian
Herbertsson	Scandinavian
Hermansen	Scandinavian
Hermanson	Scandinavian
Hermanssen	Scandinavian
Hermansson	Scandinavian
Hilmarsson	Scandinavian
Hjort	Scandinavian
Holgersen	Scandinavian
Holgersson	Scandinavian
Holmström	Scandinavian
Holst	Scandinavian
Holt	Scandinavian
Hult	Scandinavian
Ibsen	Scandinavian
Ingersson	Scandinavian
Ingesson	Scandinavian
Ingolfsson	Scandinavian
Jacobsen	Scandinavian
Jacobson	Scandinavian
Jakobsen	Scandinavian
Jansson	Scandinavian
Jensen	Scandinavian
Jensson	Scandinavian
Jespersen	Scandinavian
Johansen	Scandinavian
Johansson	Scandinavian
Johnson	Scandinavian
Jokumsen	Scandinavian
Jonasen	Scandinavian
Jonasson	Scandinavian
Jonsson	Scandinavian
Jönsson	Scandinavian
Jørgensen	Scandinavian
Karlsen	Scandinavian
Karlsson	Scandinavian
Karstensen	Scandinavian
Kaspersen	Scandinavian
Kjeldsen	Scandinavian
Kjeldsson	Scandinavian
Klassen	Scandinavian
Klasson	Scandinavian
Klausen	Scandinavian
Knudsen	Scandinavian
Knutsen	Scandinavian
Knutson	Scandinavian
Kristensen	Scandinavian
Kristiansen	Scandinavian
Kristoffersen	Scandinavian
Kron	Scandinavian
Lager	Scandinavian
Landvik	Scandinavian
Lang	Scandinavian
Lange	Scandinavian
Langenberg	Scandinavian
Larsen	Scandinavian
Larsson	Scandinavian
Lauritsen	Scandinavian
Leifsson	Scandinavian
Leonardsen	Scandinavian
Leonardson	Scandinavian
Leonardssen	Scandinavian
Leonardsson	Scandinavian
Lindberg	Scandinavian
Lindgren	Scandinavian
Lindholm	Scandinavian
Lindquist	Scandinavian
Lindström	Scandinavian
Ljung	Scandinavian
Ljungborg	Scandinavian
Ljunggren	Scandinavian
Ljungman	Scandinavian
Ljungstrand	Scandinavian
Löfgren	Scandinavian
Losnedahl	Scandinavian
Ludvigsen	Scandinavian
Lund	Scandinavian
Lundgren	Scandinavian
Lundquist	Scandinavian
Lykke	Scandinavian
Madsen	Scandinavian
Magnusson	Scandinavian
Mårdh	Scandinavian
Markusson	Scandinavian
Martinsson	Scandinavian
Mathiasen	Scandinavian
Matthiasen	Scandinavian
Mattsson	Scandinavian
Mikaelsson	Scandinavian
Mikkelsen	Scandinavian
Mortensen	Scandinavian
Munson	Scandinavian
Naess	Scandinavian
Næss	Scandinavian
Nass	Scandinavian
Ness	Scandinavian
Nielsen	Scandinavian
Nielson	Scandinavian
Niequist	Scandinavian
Niklasson	Scandinavian
Nikolajsen	Scandinavian
Nilsen	Scandinavian
Nilsson	Scandinavian
Nordskov	Scandinavian
Norling	Scandinavian
Normansen	Scandinavian
Normanson	Scandinavian
Normanssen	Scandinavian
Normansson	Scandinavian
Norup	Scandinavian
Nørup	Scandinavian
Nylund	Scandinavian
Nyström	Scandinavian
Olander	Scandinavian
Olesen	Scandinavian
Olhouser	Scandinavian
Oliversen	Scandinavian
Oliverson	Scandinavian
Oliverssen	Scandinavian
Oliversson	Scandinavian
Olofsdotter	Scandinavian
Olofsson	Scandinavian
Olsen	Scandinavian
Olsson	Scandinavian
Olvirsson	Scandinavian
Öman	Scandinavian
Omdahl	Scandinavian
Ostberg	Scandinavian
Östberg	Scandinavian
Øster	Scandinavian
Østergaard	Scandinavian
Østergård	Scandinavian
Ottosen	Scandinavian
Ottosson	Scandinavian
Ovesen	Scandinavian
Pallesen	Scandinavian
Patriksson	Scandinavian
Pedersen	Scandinavian
Persson	Scandinavian
Petersen	Scandinavian
Petersson	Scandinavian
Pettersson	Scandinavian
Pilkvist	Scandinavian
Poulsen	Scandinavian
Prebensen	Scandinavian
Ragnvaldsson	Scandinavian
Randrup	Scandinavian
Rask	Scandinavian
Raske	Scandinavian
Rasmussen	Scandinavian
Reenberg	Scandinavian
Riber	Scandinavian
Robertsen	Scandinavian
Robertsson	Scandinavian
Rolvsson	Scandinavian
Rundstrom	Scandinavian
Rupertsen	Scandinavian
Rupertson	Scandinavian
Rupertssen	Scandinavian
Rupertsson	Scandinavian
Salomon	Scandinavian
Sigurdsson	Scandinavian
Simonsen	Scandinavian
Simonsson	Scandinavian
Sinason	Scandinavian
Skjeggestad	Scandinavian
Skovgaard	Scandinavian
Solberg	Scandinavian
Sörensen	Scandinavian
Sørensen	Scandinavian
Sörenson	Scandinavian
Spillum	Scandinavian
Steensen	Scandinavian
Stefansen	Scandinavian
Stefansson	Scandinavian
Steffensen	Scandinavian
Steinsson	Scandinavian
Stenberg	Scandinavian
Stendahl	Scandinavian
Stenger	Scandinavian
Stigsson	Scandinavian
Storstrand	Scandinavian
Strand	Scandinavian
Sunden	Scandinavian
Svendsen	Scandinavian
Svenson	Scandinavian
Svensson	Scandinavian
Swenhaugen	Scandinavian
Tennfjord	Scandinavian
Thorirsson	Scandinavian
Thorn	Scandinavian
Thorsen	Scandinavian
Tjader	Scandinavian
Tomasson	Scandinavian
Toov	Scandinavian
Troelsen	Scandinavian
Ulfsson	Scandinavian
Vång	Scandinavian
Vernersen	Scandinavian
Victorsen	Scandinavian
Victorson	Scandinavian
Victorsson	Scandinavian
Vilhjalmsson	Scandinavian
Vinter	Scandinavian
Vollan	Scandinavian
Waltersen	Scandinavian
Walterson	Scandinavian
Walterssen	Scandinavian
Waltersson	Scandinavian
Westerberg	Scandinavian
Winter	Scandinavian
Wolff	Scandinavian
Acheson	Scottish
Adamson	Scottish
Aiken	Scottish
Aitken	Scottish
Allaway	Scottish
Allen	Scottish
Anderson	Scottish
Armstrong	Scottish
Atchison	Scottish
Barber	Scottish
Bateson	Scottish
Beattie	Scottish
Begbie	Scottish
Blackwood	Scottish
Blair	Scottish
Boyd	Scottish
Breckenridge	Scottish
Breckinridge	Scottish
Bruce	Scottish
Buchanan	Scottish
Calhoun	Scottish
Cameron	Scottish
Campbell	Scottish
Carr	Scottish
Chancellor	Scottish
Clacher	Scottish
Coburn	Scottish
Cockburn	Scottish
Colquhoun	Scottish
Coutts	Scottish
Cowden	Scottish
Craig	Scottish
Crawford	Scottish
Croft	Scottish
Cruickshank	Scottish
Cummins	Scottish
Cunningham	Scottish
Darrow	Scottish
David	Scottish
Davis	Scottish
Donaghue	Scottish
Donne	Scottish
Donoghue	Scottish
Drummond	Scottish
Duff	Scottish
Dunbar	Scottish
Duncan	Scottish
Duncanson	Scottish
Eads	Scottish
Fairbairn	Scottish
Faulkner	Scottish
Ferguson	Scottish
Finley	Scottish
Forney	Scottish
Fraser	Scottish
Frazier	Scottish
Gibb	Scottish
Gibbs	Scottish
Gibson	Scottish
Gordon	Scottish
Graham	Scottish
Grant	Scottish
Grieve	Scottish
Hambledon	Scottish
Hambleton	Scottish
Hameldon	Scottish
Hamilton	Scottish
Hardie	Scottish
Henderson	Scottish
Hendry	Scottish
Hepburn	Scottish
Holme	Scottish
Holmes	Scottish
Houston	Scottish
Hume	Scottish
Hunter	Scottish
Irving	Scottish
Jack	Scottish
Jardine	Scottish
Johnston	Scottish
Kennedy	Scottish
Kerr	Scottish
Kidd	Scottish
Kinnaird	Scottish
Kyles	Scottish
Lester	Scottish
Lister	Scottish
Lithgow	Scottish
Logan	Scottish
Lowry	Scottish
Lusk	Scottish
Lyne	Scottish
Lyon	Scottish
Mac Gill Fhaolain	Scottish
Mac Giolla Bhrighde	Scottish
Mac Naoimhín	Scottish
Mac Pharlain	Scottish
MacAngus	Scottish
MacAslan	Scottish
MacBay	Scottish
MacBeth	Scottish
MacBride	Scottish
MacCailín	Scottish
MacCallion	Scottish
MacCallum	Scottish
MacCance	Scottish
MacChruim	Scottish
MacClellan	Scottish
MacConnell	Scottish
MacCrum	Scottish
MacCrumb	Scottish
MacDaniel	Scottish
MacDonald	Scottish
MacDougall	Scottish
MacEachern	Scottish
MacEachthighearna	Scottish
MacEntire	Scottish
MacFarland	Scottish
MacFarlane	Scottish
MacGinnis	Scottish
MacGregor	Scottish
MacGrory	Scottish
MacIntyre	Scottish
MacIomhair	Scottish
MacIver	Scottish
MacKay	Scottish
MacKenna	Scottish
MacKenny	Scottish
MacKenzie	Scottish
MacLean	Scottish
MacLeod	Scottish
MacNeil	Scottish
MacQueen	Scottish
MacRae	Scottish
MacWilliam	Scottish
Magee	Scottish
Maguire	Scottish
Masters	Scottish
Mathaton	Scottish
Mathieson	Scottish
McAdams	Scottish
McAlister	Scottish
McArthur	Scottish
McCaig	Scottish
McCracken	Scottish
McCrae	Scottish
McCune	Scottish
McDonald	Scottish
McGee	Scottish
McGill	Scottish
McGinnis	Scottish
McGuire	Scottish
McIntyre	Scottish
McKay	Scottish
McKellar	Scottish
McLain	Scottish
McLean	Scottish
McLeod	Scottish
McMahon	Scottish
McNab	Scottish
McNabb	Scottish
McNeil	Scottish
McNeill	Scottish
McNiel	Scottish
McPhee	Scottish
McReynolds	Scottish
Melville	Scottish
Meyrick	Scottish
Milligan	Scottish
Mitchell	Scottish
Moffett	Scottish
Monroe	Scottish
Morris	Scottish
Murdoch	Scottish
Murray	Scottish
Ness	Scottish
Niven	Scottish
Oliver	Scottish
Paterson	Scottish
Patterson	Scottish
Payne	Scottish
Pottinger	Scottish
Quick	Scottish
Quickley	Scottish
Quigg	Scottish
Quigley	Scottish
Ralston	Scottish
Ramsay	Scottish
Ramsey	Scottish
Rattray	Scottish
Robertson	Scottish
Ross	Scottish
Rowe	Scottish
Rutherford	Scottish
Rutherfurd	Scottish
Sangster	Scottish
Saunders	Scottish
School	Scottish
Scott	Scottish
Shaw	Scottish
Sheach	Scottish
Sheehy	Scottish
Skeates	Scottish
Spalding	Scottish
Starrett	Scottish
Stewart	Scottish
Stroud	Scottish
Strudwick	Scottish
Stuart	Scottish
Studwick	Scottish
Sutherland	Scottish
Taggart	Scottish
Thomson	Scottish
Trask	Scottish
Turnbull	Scottish
Underwood	Scottish
Urquhart	Scottish
Waldroup	Scottish
Wallace	Scottish
Watson	Scottish
Wilkie	Scottish
Wilkins	Scottish
Wilkinson	Scottish
Wilson	Scottish
Wood	Scottish
Woods	Scottish
Adamic	Serbian
Antic	Serbian
Ateljevic	Serbian
Babic	Serbian
Bogdanic	Serbian
Bogdanovic	Serbian
Brankovic	Serbian
Broz	Serbian
Crncevic	Serbian
Davidovic	Serbian
Dragic	Serbian
Dragovic	Serbian
Filipovic	Serbian
Franic	Serbian
Franjic	Serbian
Gavrilovic	Serbian
Horvat	Serbian
Horvatincic	Serbian
Ilic	Serbian
Ivanovic	Serbian
Jankovic	Serbian
Jovanovic	Serbian
Juric	Serbian
Juriša	Serbian
Kasun	Serbian
Knezevic	Serbian
Košar	Serbian
Kovac	Serbian
Loncar	Serbian
Lukic	Serbian
Markovic	Serbian
Marusic	Serbian
Matic	Serbian
Mihailovic	Serbian
Mihajlovic	Serbian
Milic	Serbian
Milojkevic	Serbian
Miloševic	Serbian
Milovanovic	Serbian
Mlakar	Serbian
Nikolic	Serbian
Pavletic	Serbian
Pavlovic	Serbian
Perko	Serbian
Petric	Serbian
Petrovic	Serbian
Radic	Serbian
Stankic	Serbian
Stefanovic	Serbian
Stjepanic	Serbian
Stojanovic	Serbian
Tomcic	Serbian
Vinkovic	Serbian
Vlahovic	Serbian
Vlasic	Serbian
Vlašic	Serbian
Vukoja	Serbian
Zivkovic	Serbian
Zoric	Serbian
Zupan	Serbian
Adamik	Slovak
Andres	Slovak
Banik	Slovak
Baracnik	Slovak
Bartoš	Slovak
Beneš	Slovak
Beran	Slovak
Bernard	Slovak
Biskup	Slovak
Blaha	Slovak
Blažek	Slovak
Bobal	Slovak
Bosko	Slovak
Brož	Slovak
Buranek	Slovak
Bureš	Slovak
Cech	Slovak
Cermak	Slovak
Cernik	Slovak
Cerny	Slovak
Cervenka	Slovak
Chalupa	Slovak
Chalupnik	Slovak
Chmela	Slovak
Chvátal	Slovak
Ciernik	Slovak
Cipris	Slovak
Cižek	Slovak
Ctvrtlanik	Slovak
Ctvrtnik	Slovak
David	Slovak
Doležal	Slovak
Doubek	Slovak
Dušek	Slovak
Dvorak	Slovak
Fiala	Slovak
Filipek	Slovak
Hajek	Slovak
Havel	Slovak
Havelka	Slovak
Holub	Slovak
Horacek	Slovak
Horak	Slovak
Hornick	Slovak
Hornik	Slovak
Hrabe	Slovak
Hruby	Slovak
Hruška	Slovak
Hustovi	Slovak
Jahoda	Slovak
Janda	Slovak
Jankovic	Slovak
Jedlicka	Slovak
Jelen	Slovak
Jelinek	Slovak
Ježek	Slovak
Kadlec	Slovak
Kašpar	Slovak
Kladivo	Slovak
Klima	Slovak
Klímek	Slovak
Klimy	Slovak
Kohout	Slovak
Kolar	Slovak
Kopecky	Slovak
Kostelecky	Slovak
Kovac	Slovak
Kovác	Slovak
Kovár	Slovak
Krall	Slovak
Kramr	Slovak
Kratochvil	Slovak
Krejci	Slovak
Križ	Slovak
Kucera	Slovak
Kudrna	Slovak
Kysely	Slovak
Lanik	Slovak
Láska	Slovak
Lukska	Slovak
Macek	Slovak
Maly	Slovak
Marek	Slovak
Martinek	Slovak
Maruska	Slovak
Mašek	Slovak
Maselnika	Slovak
Matejka	Slovak
Matoušek	Slovak
Medved	Slovak
Mlynarik	Slovak
Moravec	Slovak
Musil	Slovak
Myska	Slovak
Navrátil	Slovak
Nedbalek	Slovak
Nedved	Slovak
Nemec	Slovak
Nosek	Slovak
Novak	Slovak
Novosad	Slovak
Novotny	Slovak
Pechacek	Slovak
Pešek	Slovak
Podsednik	Slovak
Pokorny	Slovak
Polak	Slovak
Pololanik	Slovak
Pospíšil	Slovak
Pražak	Slovak
Prochazka	Slovak
Pulkrábek	Slovak
Pulnik	Slovak
Reha	Slovak
Reznicek	Slovak
Rezník	Slovak
Rybar	Slovak
Sasha	Slovak
Schovajsa	Slovak
Sedlak	Slovak
Šimek	Slovak
Simon	Slovak
Skala	Slovak
Skalicky	Slovak
Slavik	Slovak
Slezak	Slovak
Slovak	Slovak
Smolák	Slovak
Sokol	Slovak
Sokoll	Slovak
Stárek	Slovak
Starosta	Slovak
Štepanek	Slovak
Strnad	Slovak
Suchý	Slovak
Svoboda	Slovak
Sykora	Slovak
Tesar	Slovak
Tesarik	Slovak
Vacek	Slovak
Vacik	Slovak
Valenta	Slovak
Vancura	Slovak
Vanek	Slovak
Vašek	Slovak
Vavra	Slovak
Vesela	Slovak
Vesely	Slovak
Vlasák	Slovak
Vrubel	Slovak
Wentrcek	Slovak
Yedlicka	Slovak
Zahradnik	Slovak
Zelenka	Slovak
Zeman	Slovak
Zíma	Slovak
Žitník	Slovak
Zupan	Slovak
Babic	Slovene
Brankovic	Slovene
Broz	Slovene
Cižek	Slovene
Gašpar	Slovene
Gerbic	Slovene
Horvat	Slovene
Jakolin	Slovene
Jankovic	Slovene
Kaluža	Slovene
Kaspar	Slovene
Kašpar	Slovene
Klements	Slovene
Kokot	Slovene
Kolar	Slovene
Kopitar	Slovene
Korošec	Slovene
Kovac	Slovene
Kozel	Slovene
Križ	Slovene
Krizman	Slovene
Loncar	Slovene
Mlakar	Slovene
Mlekuc	Slovene
Novak	Slovene
Perko	Slovene
Plešec	Slovene
Pleško	Slovene
Resnik	Slovene
Strnad	Slovene
Struna	Slovene
Tomcic	Slovene
Vlašic	Slovene
Žitnik	Slovene
Zupan	Slovene
Abana	Spanish
Abano	Spanish
Abarca	Spanish
Abascal	Spanish
Abel	Spanish
Aberquero	Spanish
Acosta	Spanish
Aiza	Spanish
Alamilla	Spanish
Albuquerque	Spanish
Alfaro	Spanish
Alvarado	Spanish
Alves	Spanish
Amador	Spanish
Antúnez	Spanish
Aqua	Spanish
Aquino	Spanish
Araújo	Spanish
Araullo	Spanish
Araya	Spanish
Arce	Spanish
Arechavaleta	Spanish
Arena	Spanish
Aritza	Spanish
Armando	Spanish
Arreola	Spanish
Arriola	Spanish
Asis	Spanish
Asturias	Spanish
Avana	Spanish
Banderas	Spanish
Barros	Spanish
Basurto	Spanish
Bautista	Spanish
Bello	Spanish
Belmonte	Spanish
Bengochea	Spanish
Benitez	Spanish
Bermúdez	Spanish
Blanco	Spanish
Bolívar	Spanish
Bosque	Spanish
Bustillo	Spanish
Busto	Spanish
Bustos	Spanish
Cabello	Spanish
Cabrera	Spanish
Campo	Spanish
Campos	Spanish
Cardona	Spanish
Caro	Spanish
Casales	Spanish
Castellano	Spanish
Castillion	Spanish
Castillo	Spanish
Castro	Spanish
Chavarría	Spanish
Chavez	Spanish
Colón	Spanish
Costa	Spanish
Crespo	Spanish
Cruz	Spanish
Cuéllar	Spanish
Cuevas	Spanish
D'Cruz	Spanish
D'Cruze	Spanish
De la Cruz	Spanish
De la Fuente	Spanish
De Leon	Spanish
De Santigo	Spanish
Del Bosque	Spanish
Del Olmo	Spanish
Delgado	Spanish
Díaz	Spanish
Dominguez	Spanish
Duarte	Spanish
Durante	Spanish
Echevarría	Spanish
Echeverría	Spanish
Elizondo	Spanish
Escamilla	Spanish
Escárcega	Spanish
Escarrà	Spanish
Esparza	Spanish
Espina	Spanish
Espino	Spanish
Espinosa	Spanish
Espinoza	Spanish
Estévez	Spanish
Félix	Spanish
Fernandez	Spanish
Fierro	Spanish
Flores	Spanish
Fonseca	Spanish
Franco	Spanish
Fuentes	Spanish
Gallego	Spanish
Gallo	Spanish
Garcia	Spanish
Garza	Spanish
Gaspar	Spanish
Gomez	Spanish
Gonzales	Spanish
Gonzalez	Spanish
Guadarrama	Spanish
Guerra	Spanish
Guerrero	Spanish
Gutierrez	Spanish
Gutiérrez	Spanish
Hernandez	Spanish
Herrero	Spanish
Hierro	Spanish
Hildebrand	Spanish
Hinrichs	Spanish
Hintzen	Spanish
Hoch	Spanish
Hochberg	Spanish
Hoefler	Spanish
Hofer	Spanish
Hoffman	Spanish
Hoffmann	Spanish
Höfler	Spanish
Hofmann	Spanish
Hofmeister	Spanish
Holguín	Spanish
Holst	Spanish
Holtzer	Spanish
Holzer	Spanish
Hölzer	Spanish
Holzknecht	Spanish
Holzmann	Spanish
Hoover	Spanish
Horowitz	Spanish
Houk	Spanish
Huber	Spanish
Hüber	Spanish
Huerta	Spanish
Huff	Spanish
Huffman	Spanish
Huffmann	Spanish
Hutmacher	Spanish
Ibáñez	Spanish
Ibarra	Spanish
Ingersleben	Spanish
Iñíguez	Spanish
Jaeger	Spanish
Jager	Spanish
Jäger	Spanish
Jans	Spanish
Janson	Spanish
Janz	Spanish
Jasso	Spanish
Jollenbeck	Spanish
Juárez	Spanish
Jund	Spanish
Jung	Spanish
Junge	Spanish
Kahler	Spanish
Kaiser	Spanish
Kalb	Spanish
Kalbfleisch	Spanish
Kappel	Spanish
Karl	Spanish
Kaspar	Spanish
Kassmeyer	Spanish
Kästner	Spanish
Kaube	Spanish
Kaufer	Spanish
Käufer	Spanish
Kauffmann	Spanish
Kaufman	Spanish
Keil	Spanish
Keller	Spanish
Kempf	Spanish
Kerner	Spanish
Kerper	Spanish
Kerwar	Spanish
Kerwer	Spanish
Kiefer	Spanish
Kirchner	Spanish
Kistler	Spanish
Kistner	Spanish
Kleid	Spanish
Klein	Spanish
Klossner	Spanish
Knef	Spanish
Kneib	Spanish
Kneller	Spanish
Knepp	Spanish
Knochenmus	Spanish
Knopf	Spanish
Knopp	Spanish
Koch	Spanish
Kock	Spanish
Koenig	Spanish
Koenigsmann	Spanish
Kohl	Spanish
Köhl	Spanish
Kohler	Spanish
Köhler	Spanish
Kolbe	Spanish
König	Spanish
Kopp	Spanish
Kraemer	Spanish
Kramer	Spanish
Krämer	Spanish
Krantz	Spanish
Kranz	Spanish
Kraus	Spanish
Krause	Spanish
Krauss	Spanish
Krauß	Spanish
Krebs	Spanish
Kröger	Spanish
Kron	Spanish
Kruckel	Spanish
Kruger	Spanish
Küchler	Spanish
Kuhn	Spanish
Kundert	Spanish
Kunkel	Spanish
Kunkle	Spanish
Kuntz	Spanish
Kunze	Spanish
Kurzmann	Spanish
Laberenz	Spanish
Lafrentz	Spanish
Lafrenz	Spanish
Landau	Spanish
Lang	Spanish
Lange	Spanish
Langenberg	Spanish
Langer	Spanish
Larenz	Spanish
Laurenz	Spanish
Lauritz	Spanish
Lawerenz	Spanish
Lawrenz	Spanish
Lehmann	Spanish
Lehrer	Spanish
Leitner	Spanish
Leitz	Spanish
Leitzke	Spanish
Lenz	Spanish
Leverenz	Spanish
Lewerentz	Spanish
Lewerenz	Spanish
Lichtenberg	Spanish
Lieberenz	Spanish
Linden	Spanish
Lobo	Spanish
Loewe	Spanish
Lohrenz	Spanish
Lopez	Spanish
Lorentz	Spanish
Lorenz	Spanish
Lorenzen	Spanish
Loris	Spanish
Loritz	Spanish
Losa	Spanish
Löwe	Spanish
Loyola	Spanish
Ludwig	Spanish
Luther	Spanish
M&ouml;ller	Spanish
Maas	Spanish
Machado	Spanish
Macías	Spanish
Maier	Spanish
Mandel	Spanish
Mandelbaum	Spanish
Mann	Spanish
Maradona	Spanish
María	Spanish
Marino	Spanish
Marquering	Spanish
Marqueringh	Spanish
Marquerink	Spanish
Márquez	Spanish
Martin	Spanish
Martinez	Spanish
Martz	Spanish
Mata	Spanish
Maurell	Spanish
Maurer	Spanish
Maus	Spanish
Medina	Spanish
Meier	Spanish
Mein	Spanish
Meindl	Spanish
Meinhardt	Spanish
Meisner	Spanish
Meissner	Spanish
Melendez	Spanish
Melsbach	Spanish
Mendel	Spanish
Mendelsohn	Spanish
Mendelssohn	Spanish
Méndez	Spanish
Menendez	Spanish
Merlo	Spanish
Messerli	Spanish
Messmann	Spanish
Messner	Spanish
Metzger	Spanish
Mingo	Spanish
Mohren	Spanish
Moles	Spanish
Molina	Spanish
Montero	Spanish
Morales	Spanish
Moralez	Spanish
Moreno	Spanish
Morgenstern	Spanish
Moser	Spanish
Mueller	Spanish
Muhlfeld	Spanish
Müller	Spanish
Nagel	Spanish
Narváez	Spanish
Neuman	Spanish
Neumann	Spanish
Nieves	Spanish
Noguerra	Spanish
Núñez	Spanish
Nuremberg	Spanish
Nussbaum	Spanish
Nussenbaum	Spanish
Obando	Spanish
Oberst	Spanish
Ochoa	Spanish
Oelberg	Spanish
Ohme	Spanish
Ojeda	Spanish
Oleastro	Spanish
Olguin	Spanish
Oliver	Spanish
Olmos	Spanish
Oppenheimer	Spanish
Oquendo	Spanish
Orellana	Spanish
Ortiz	Spanish
Otto	Spanish
Oursler	Spanish
Pahlke	Spanish
Palomo	Spanish
Papke	Spanish
Paredes	Spanish
Paulis	Spanish
Pavia	Spanish
Pawlitzki	Spanish
Peláez	Spanish
Peña	Spanish
Penzig	Spanish
Perez	Spanish
Peter	Spanish
Peters	Spanish
Pfaff	Spanish
Pfenning	Spanish
Plank	Spanish
Pletcher	Spanish
Porras	Spanish
Portner	Spanish
Prieto	Spanish
Prinz	Spanish
Protz	Spanish
Puerta	Spanish
Puga	Spanish
Puig	Spanish
Quinones	Spanish
Quintana	Spanish
Quirós	Spanish
Rademacher	Spanish
Rademaker	Spanish
Ramires	Spanish
Ramirez	Spanish
Ramos	Spanish
Rana	Spanish
Raske	Spanish
Raskob	Spanish
Raskop	Spanish
Raskoph	Spanish
Regenbogen	Spanish
Reier	Spanish
Reiher	Spanish
Reiter	Spanish
Rendón	Spanish
Rettig	Spanish
Richard	Spanish
Richter	Spanish
Rier	Spanish
Riese	Spanish
Rios	Spanish
Ritter	Spanish
Rivera	Spanish
Rivero	Spanish
Robledo	Spanish
Robles	Spanish
Rodriguez	Spanish
Rojas	Spanish
Rojo	Spanish
Roldán	Spanish
Rosales	Spanish
Rosenberg	Spanish
Rosenberger	Spanish
Rosenfeld	Spanish
Roth	Spanish
Rothbauer	Spanish
Rothenberg	Spanish
Rothschild	Spanish
Rubio	Spanish
Ruiz	Spanish
Sachs	Spanish
Sala	Spanish
Salamanca	Spanish
Salazar	Spanish
Salcedo	Spanish
Salinas	Spanish
Salomon	Spanish
Salzwedel	Spanish
Samson	Spanish
Samuel	Spanish
San Nicolas	Spanish
Sanchez	Spanish
Sander	Spanish
Sandoval	Spanish
Santana	Spanish
Santiago	Spanish
Santillian	Spanish
Santos	Spanish
Sastre	Spanish
Sauber	Spanish
Schäfer	Spanish
Scheer	Spanish
Scheinberg	Spanish
Schenck	Spanish
Schermer	Spanish
Schindler	Spanish
Schirmer	Spanish
Schlender	Spanish
Schlimme	Spanish
Schlusser	Spanish
Schmeling	Spanish
Schmid	Spanish
Schmidt	Spanish
Schmitt	Spanish
Schmitz	Spanish
Schnoor	Spanish
Schnur	Spanish
Schoettmer	Spanish
Schrader	Spanish
Schräder	Spanish
Schreck	Spanish
Schreier	Spanish
Schroeder	Spanish
Schroeter	Spanish
Schröter	Spanish
Schubert	Spanish
Schuchard	Spanish
Schuchardt	Spanish
Schuchert	Spanish
Schuhart	Spanish
Schuhmacher	Spanish
Schuler	Spanish
Schult	Spanish
Schulte	Spanish
Schultes	Spanish
Schultheis	Spanish
Schultheiss	Spanish
Schultheiß	Spanish
Schultz	Spanish
Schultze	Spanish
Schulz	Spanish
Schulze	Spanish
Schumacher	Spanish
Schuster	Spanish
Schuttmann	Spanish
Schwangau	Spanish
Schwartz	Spanish
Schwarz	Spanish
Schwarzenegger	Spanish
Schwenke	Spanish
Schwinghammer	Spanish
Seelenfreund	Spanish
Seidel	Spanish
Sepúlveda	Spanish
Sheinfeld	Spanish
Shriver	Spanish
Siekert	Spanish
Siemon	Spanish
Sierra	Spanish
Silva	Spanish
Silverstein	Spanish
Simen	Spanish
Simmon	Spanish
Simon	Spanish
Simons	Spanish
Sinasohn	Spanish
Siskin	Spanish
Siskind	Spanish
Slusser	Spanish
Solberg	Spanish
Solos	Spanish
Sonnen	Spanish
Sorg	Spanish
Sorge	Spanish
Spannagel	Spanish
Specht	Spanish
Spellmeyer	Spanish
Spitznogle	Spanish
Sponaugle	Spanish
Stark	Spanish
Stauss	Spanish
Steen	Spanish
Steffen	Spanish
Stein	Spanish
Steinmann	Spanish
Stenger	Spanish
Sternberg	Spanish
Steube	Spanish
Steuben	Spanish
Stieber	Spanish
Strand	Spanish
Straub	Spanish
Strobel	Spanish
Strohkirch	Spanish
Stroman	Spanish
Stuber	Spanish
Stueck	Spanish
Stumpf	Spanish
Sturm	Spanish
Suárez	Spanish
Suero	Spanish
Suess	Spanish
Sulzbach	Spanish
Swango	Spanish
Switzer	Spanish
Tangeman	Spanish
Tapia	Spanish
Terrazas	Spanish
Teufel	Spanish
Tiedeman	Spanish
Tifft (1)	Spanish
Tillens	Spanish
Tobias	Spanish
Tolkien	Spanish
Torres	Spanish
Travieso	Spanish
Tresler	Spanish
Tritten	Spanish
Trujillo	Spanish
Trumbauer	Spanish
Tschida	Spanish
Ubina	Spanish
Unkle	Spanish
Unruh	Spanish
Unterbrink	Spanish
Urbina	Spanish
Ureña	Spanish
Ursler	Spanish
Valdez	Spanish
Valencia	Spanish
Van Tonder	Spanish
Varela	Spanish
Vargas	Spanish
Vásquez	Spanish
Vázquez	Spanish
Vega	Spanish
Velazquez	Spanish
Venetianer	Spanish
Ventura	Spanish
Vicario	Spanish
Victor	Spanish
Victor	Spanish
Victore	Spanish
Vieth	Spanish
Villa	Spanish
Villalobos	Spanish
Villanueva	Spanish
Villaverde	Spanish
Viola	Spanish
Viteri	Spanish
Vives	Spanish
Vogel	Spanish
Vogt	Spanish
Vogts	Spanish
Voigt	Spanish
Voigts	Spanish
Volk	Spanish
Von Brandt	Spanish
Von Essen	Spanish
Von Grimmelshausen	Spanish
Von Ingersleben	Spanish
Von Wegberg	Spanish
Vonnegut	Spanish
Voss	Spanish
Wagner	Spanish
Wägner	Spanish
Wahner	Spanish
Wähner	Spanish
Waldfogel	Spanish
Waldvogel	Spanish
Walkenhorst	Spanish
Walter	Spanish
Walther	Spanish
Waltz	Spanish
Warner	Spanish
Waxweiler	Spanish
Weber	Spanish
Wechsler	Spanish
Wedekind	Spanish
Weeber	Spanish
Wegener	Spanish
Wegner	Spanish
Wehner	Spanish
Wehunt	Spanish
Weigand	Spanish
Weiman	Spanish
Weiner	Spanish
Weiss	Spanish
Weiß	Spanish
Welter	Spanish
Werner	Spanish
Wernerus	Spanish
Wernher	Spanish
Westerberg	Spanish
Wetterman	Spanish
Wetzel	Spanish
Wexler	Spanish
Wieck	Spanish
Wiegand	Spanish
Wildgrube	Spanish
Winter	Spanish
Wirner	Spanish
Wirnhier	Spanish
Wirt	Spanish
Wirth	Spanish
Wolf	Spanish
Wolff	Spanish
Wolter	Spanish
Wörner	Spanish
Wörnhör	Spanish
Wruck	Spanish
Ybarra	Spanish
Zamorano	Spanish
Zapatero	Spanish
Zavala	Spanish
Zellweger	Spanish
Zilberschlag	Spanish
Zimmerman	Spanish
Zimmermann	Spanish
Zubizarreta	Spanish
Abrahamsen	Swedish
Abrahamssen	Swedish
Abrahamsson	Swedish
Abramsen	Swedish
Abramssen	Swedish
Abramsson	Swedish
Adamsen	Swedish
Adamssen	Swedish
Adamsson	Swedish
Adolfsson	Swedish
Adolvsson	Swedish
Ahlberg	Swedish
Ahlgren	Swedish
Ahlström	Swedish
Albertson	Swedish
Albertsson	Swedish
Albinson	Swedish
Albinsson	Swedish
Albrechtsson	Swedish
Albrecktsson	Swedish
Albrektson	Swedish
Albrektsson	Swedish
Alexanderson	Swedish
Alexandersson	Swedish
Alfredsson	Swedish
Alfsson	Swedish
Almstedt	Swedish
Alvarsson	Swedish
Anderson	Swedish
Andersson	Swedish
Andreasson	Swedish
Andréasson	Swedish
Arthurson	Swedish
Arthurssen	Swedish
Arthursson	Swedish
Axelsson	Swedish
Bengtsdotter	Swedish
Bengtsson	Swedish
Berg	Swedish
Bergfalk	Swedish
Bergman	Swedish
Bergström	Swedish
Bernardsen	Swedish
Bernardssen	Swedish
Bernardsson	Swedish
Björk	Swedish
Bjorkman	Swedish
Björnsson	Swedish
Blom	Swedish
Blomgren	Swedish
Borg	Swedish
Byquist	Swedish
Byström	Swedish
Claesson	Swedish
Dahl	Swedish
Danielsson	Swedish
Einarsson	Swedish
Eklund	Swedish
Elmersen	Swedish
Elmerson	Swedish
Elmerssen	Swedish
Elmersson	Swedish
Engberg	Swedish
Engman	Swedish
Engström	Swedish
Ericson	Swedish
Eriksson	Swedish
Falk	Swedish
Frisk	Swedish
Gerhardsson	Swedish
Göransson	Swedish
Grahn	Swedish
Gunnarsson	Swedish
Gunvaldsson	Swedish
Gustafsson	Swedish
Haakonsson	Swedish
Hall	Swedish
Hallman	Swedish
Hansson	Swedish
Herbertsen	Swedish
Herbertson	Swedish
Herbertssen	Swedish
Herbertsson	Swedish
Hermansen	Swedish
Hermanson	Swedish
Hermanssen	Swedish
Hermansson	Swedish
Holgersson	Swedish
Holmström	Swedish
Hult	Swedish
Ingersson	Swedish
Ingesson	Swedish
Jansson	Swedish
Jensson	Swedish
Johansson	Swedish
Johnson	Swedish
Jonasson	Swedish
Jonsson	Swedish
Jönsson	Swedish
Karlsson	Swedish
Kjeldsson	Swedish
Klasson	Swedish
Knutsen	Swedish
Knutson	Swedish
Kron	Swedish
Lager	Swedish
Langenberg	Swedish
Larsson	Swedish
Leifsson	Swedish
Leonardsen	Swedish
Leonardson	Swedish
Leonardssen	Swedish
Leonardsson	Swedish
Lindberg	Swedish
Lindgren	Swedish
Lindholm	Swedish
Lindquist	Swedish
Lindström	Swedish
Ljung	Swedish
Ljungborg	Swedish
Ljunggren	Swedish
Ljungman	Swedish
Ljungstrand	Swedish
Löfgren	Swedish
Lund	Swedish
Lundgren	Swedish
Lundquist	Swedish
Magnusson	Swedish
Mårdh	Swedish
Markusson	Swedish
Martinsson	Swedish
Mattsson	Swedish
Mikaelsson	Swedish
Munson	Swedish
Nielson	Swedish
Niequist	Swedish
Niklasson	Swedish
Nilsson	Swedish
Norling	Swedish
Normansen	Swedish
Normanson	Swedish
Normanssen	Swedish
Normansson	Swedish
Nylund	Swedish
Nyström	Swedish
Olander	Swedish
Oliverson	Swedish
Oliverssen	Swedish
Oliversson	Swedish
Olofsdotter	Swedish
Olofsson	Swedish
Olsson	Swedish
Öman	Swedish
Östberg	Swedish
Ottosson	Swedish
Patriksson	Swedish
Persson	Swedish
Petersson	Swedish
Pettersson	Swedish
Pilkvist	Swedish
Ragnvaldsson	Swedish
Robertsson	Swedish
Rundstrom	Swedish
Rupertsen	Swedish
Rupertson	Swedish
Rupertssen	Swedish
Rupertsson	Swedish
Simonsson	Swedish
Sinason	Swedish
Solberg	Swedish
Sörensen	Swedish
Sörenson	Swedish
Stefansson	Swedish
Stenberg	Swedish
Stendahl	Swedish
Stigsson	Swedish
Strand	Swedish
Sunden	Swedish
Svenson	Swedish
Svensson	Swedish
Tjader	Swedish
Tomasson	Swedish
Ulfsson	Swedish
Vång	Swedish
Victorson	Swedish
Victorsson	Swedish
Vinter	Swedish
Waltersen	Swedish
Walterson	Swedish
Walterssen	Swedish
Waltersson	Swedish
Westerberg	Swedish
Winter	Swedish
Metharom	Thai
Budny	Ukrainian
Chownyk	Ukrainian
Gavrilyuk	Ukrainian
Holub	Ukrainian
Kaminski	Ukrainian
Kedzierski	Ukrainian
Kohut	Ukrainian
Kozel	Ukrainian
Pasternack	Ukrainian
Pasternak	Ukrainian
Sewick	Ukrainian
Shwetz	Ukrainian
Stasiuk	Ukrainian
Wasylyk	Ukrainian
Wasylyshyn	Ukrainian
Wolanski	Ukrainian
Zelenko	Ukrainian
5	Welsh
Abel	Welsh
Abrahamsen	Welsh
Abrahamssen	Welsh
Abrahamsson	Welsh
Abramsen	Welsh
Abramssen	Welsh
Abramsson	Welsh
Adamsen	Welsh
Adamssen	Welsh
Adamsson	Welsh
Adolfsson	Welsh
Adolvsson	Welsh
Agnarsson	Welsh
Ahlberg	Welsh
Ahlgren	Welsh
Ahlström	Welsh
Akselsen	Welsh
Albertsen	Welsh
Albertson	Welsh
Albertsson	Welsh
Albinson	Welsh
Albinsson	Welsh
Albrechtsson	Welsh
Albrecktsson	Welsh
Albrektson	Welsh
Albrektsson	Welsh
Alexandersen	Welsh
Alexanderson	Welsh
Alexandersson	Welsh
Alfredsson	Welsh
Alfsson	Welsh
Almstedt	Welsh
Alvarsson	Welsh
Andersen	Welsh
Anderson	Welsh
Andersson	Welsh
Andreasen	Welsh
Andreasson	Welsh
Andréasson	Welsh
Anthonsen	Welsh
Antonsen	Welsh
Ármannsson	Welsh
Arnesen	Welsh
Arthursen	Welsh
Arthurson	Welsh
Arthurssen	Welsh
Arthursson	Welsh
Årud	Welsh
Axelsen	Welsh
Axelsson	Welsh
Baardsson	Welsh
Bager	Welsh
Bendtsen	Welsh
Bengtsdotter	Welsh
Bengtsson	Welsh
Bentsen	Welsh
Berg	Welsh
Bergfalk	Welsh
Bergman	Welsh
Bergström	Welsh
Bernardsen	Welsh
Bernardssen	Welsh
Bernardsson	Welsh
Bjarnesen	Welsh
Björk	Welsh
Bjorkman	Welsh
Björnsson	Welsh
Blom	Welsh
Blomgren	Welsh
Bodilsen	Welsh
Borg	Welsh
Byquist	Welsh
Byström	Welsh
Carlsen	Welsh
Carlson	Welsh
Carstensen	Welsh
Christensen	Welsh
Christiansen	Welsh
Christoffersen	Welsh
Claesson	Welsh
Clausen	Welsh
Clemensen	Welsh
Dahl	Welsh
Danielsen	Welsh
Danielsson	Welsh
Davidsen	Welsh
Doctor	Welsh
Einarsson	Welsh
Eklund	Welsh
Elmersen	Welsh
Elmerson	Welsh
Elmerssen	Welsh
Elmersson	Welsh
Engberg	Welsh
Engman	Welsh
Engström	Welsh
Erickson	Welsh
Ericson	Welsh
Eriksen	Welsh
Eriksson	Welsh
Falk	Welsh
Fisker	Welsh
Frederiksen	Welsh
Frisk	Welsh
Gerhardsson	Welsh
Giese	Welsh
Göransson	Welsh
Grahn	Welsh
Gulbrandsen	Welsh
Guldbrandsen	Welsh
Gunnarsen	Welsh
Gunnarsson	Welsh
Gunvaldsson	Welsh
Gustafsson	Welsh
Haakonsson	Welsh
Hagebak	Welsh
Hall	Welsh
Hallman	Welsh
Hansson	Welsh
Haraldsson	Welsh
Haugen	Welsh
Heimirsson	Welsh
Henningsen	Welsh
Henriksen	Welsh
Herbertsen	Welsh
Herbertson	Welsh
Herbertssen	Welsh
Herbertsson	Welsh
Hermansen	Welsh
Hermanson	Welsh
Hermanssen	Welsh
Hermansson	Welsh
Hilmarsson	Welsh
Hjort	Welsh
Holgersen	Welsh
Holgersson	Welsh
Holmström	Welsh
Holst	Welsh
Holt	Welsh
Hult	Welsh
Ibsen	Welsh
Ingersson	Welsh
Ingesson	Welsh
Ingolfsson	Welsh
Jacobsen	Welsh
Jacobson	Welsh
Jakobsen	Welsh
Jansson	Welsh
Jensen	Welsh
Jensson	Welsh
Jespersen	Welsh
Johansen	Welsh
Johansson	Welsh
Johnson	Welsh
Jokumsen	Welsh
Jonasen	Welsh
Jonasson	Welsh
Jonsson	Welsh
Jönsson	Welsh
Jørgensen	Welsh
Karlsen	Welsh
Karlsson	Welsh
Karstensen	Welsh
Kaspersen	Welsh
Kjeldsen	Welsh
Kjeldsson	Welsh
Klassen	Welsh
Klasson	Welsh
Klausen	Welsh
Knudsen	Welsh
Knutsen	Welsh
Knutson	Welsh
Kristensen	Welsh
Kristiansen	Welsh
Kristoffersen	Welsh
Kron	Welsh
Lager	Welsh
Landvik	Welsh
Lang	Welsh
Lange	Welsh
Langenberg	Welsh
Larsen	Welsh
Larsson	Welsh
Lauritsen	Welsh
Leifsson	Welsh
Leonardsen	Welsh
Leonardson	Welsh
Leonardssen	Welsh
Leonardsson	Welsh
Lindberg	Welsh
Lindgren	Welsh
Lindholm	Welsh
Lindquist	Welsh
Lindström	Welsh
Ljung	Welsh
Ljungborg	Welsh
Ljunggren	Welsh
Ljungman	Welsh
Ljungstrand	Welsh
Löfgren	Welsh
Losnedahl	Welsh
Ludvigsen	Welsh
Lund	Welsh
Lundgren	Welsh
Lundquist	Welsh
Lykke	Welsh
Madsen	Welsh
Magnusson	Welsh
Mårdh	Welsh
Markusson	Welsh
Martinsson	Welsh
Mathiasen	Welsh
Matthiasen	Welsh
Mattsson	Welsh
Mikaelsson	Welsh
Mikkelsen	Welsh
Mortensen	Welsh
Munson	Welsh
Naess	Welsh
Næss	Welsh
Nass	Welsh
Ness	Welsh
Nielsen	Welsh
Nielson	Welsh
Niequist	Welsh
Niklasson	Welsh
Nikolajsen	Welsh
Nilsen	Welsh
Nilsson	Welsh
Nordskov	Welsh
Norling	Welsh
Normansen	Welsh
Normanson	Welsh
Normanssen	Welsh
Normansson	Welsh
Norup	Welsh
Nørup	Welsh
Nylund	Welsh
Nyström	Welsh
Olander	Welsh
Olesen	Welsh
Olhouser	Welsh
Oliversen	Welsh
Oliverson	Welsh
Oliverssen	Welsh
Oliversson	Welsh
Olofsdotter	Welsh
Olofsson	Welsh
Olsen	Welsh
Olsson	Welsh
Olvirsson	Welsh
Öman	Welsh
Omdahl	Welsh
Ostberg	Welsh
Östberg	Welsh
Øster	Welsh
Østergaard	Welsh
Østergård	Welsh
Ottosen	Welsh
Ottosson	Welsh
Ovesen	Welsh
Pallesen	Welsh
Patriksson	Welsh
Pedersen	Welsh
Persson	Welsh
Petersen	Welsh
Petersson	Welsh
Pettersson	Welsh
Pilkvist	Welsh
Poulsen	Welsh
Prebensen	Welsh
Ragnvaldsson	Welsh
Randrup	Welsh
Rask	Welsh
Raske	Welsh
Rasmussen	Welsh
Reenberg	Welsh
Riber	Welsh
Robertsen	Welsh
Robertsson	Welsh
Rolvsson	Welsh
Rundstrom	Welsh
Rupertsen	Welsh
Rupertson	Welsh
Rupertssen	Welsh
Rupertsson	Welsh
Salomon	Welsh
Sigurdsson	Welsh
Simonsen	Welsh
Simonsson	Welsh
Sinason	Welsh
Skjeggestad	Welsh
Skovgaard	Welsh
Solberg	Welsh
Sörensen	Welsh
Sørensen	Welsh
Sörenson	Welsh
Spillum	Welsh
Steensen	Welsh
Stefansen	Welsh
Stefansson	Welsh
Steffensen	Welsh
Steinsson	Welsh
Stenberg	Welsh
Stendahl	Welsh
Stenger	Welsh
Stigsson	Welsh
Storstrand	Welsh
Strand	Welsh
Sunden	Welsh
Svendsen	Welsh
Svenson	Welsh
Svensson	Welsh
Swenhaugen	Welsh
Tennfjord	Welsh
Thorirsson	Welsh
Thorn	Welsh
Thorsen	Welsh
Tjader	Welsh
Tomasson	Welsh
Toov	Welsh
Troelsen	Welsh
Ulfsson	Welsh
Vång	Welsh
Vernersen	Welsh
Victorsen	Welsh
Victorson	Welsh
Victorsson	Welsh
Vilhjalmsson	Welsh
Vinter	Welsh
Vollan	Welsh
Waltersen	Welsh
Walterson	Welsh
Walterssen	Welsh
Waltersson	Welsh
Westerberg	Welsh
Winter	Welsh
Wolff	Welsh
